"id","countyfips","year","births","censusbuildingpermits","deaths","groupquarterspopulation","householdpopulation","households","householdsize","naturalincrease","netmigration","totalhousingunits","vacancyrate","vacanthousingunits","totalpopulation"
1,0,1985,55115,30898,20234,81139,3133309,1221557,2.565012,34881,5317,1402558,12.90506,181001,3214448
2,0,1986,55142,30280,20768,82109,3161694,1243453,2.542673,34374,-5731,1436610,13.44533,193157,3243803
3,0,1987,53803,17449,21089,83419,3179935,1258199,2.52737,32714,-14299,1467981,14.29051,209782,3263354
4,0,1988,53346,12371,21312,86810,3184638,1267288,2.512955,32034,-24046,1486346,14.73802,219058,3271448
5,0,1989,52697,10740,21056,87671,3196866,1282386,2.492905,31641,-18698,1497046,14.3389,214660,3284537
6,0,1990,53491,11388,21514,79551,3224491,1282488,2.514246,31977,-12584,1477349,13.18991,194861,3304042
7,0,1991,53530,13450,22096,81719,3299232,1313504,2.511779,31434,45475,1488886,11.77941,175382,3380951
8,0,1992,54545,23057,22426,84669,3405163,1354139,2.514633,32119,76762,1503198,9.916125,149059,3489832
9,0,1993,54100,29791,23171,89323,3515715,1386998,2.534766,30929,84277,1527392,9.191747,140394,3605038
10,0,1994,53788,36748,23828,90658,3621404,1418294,2.553352,29960,77064,1557549,8.94065,139255,3712062
11,0,1995,53869,38618,24724,93604,3717470,1451449,2.561213,29145,69867,1594454,8.968901,143005,3811074
12,0,1996,54974,41135,25083,99958,3802490,1483877,2.562537,29891,61483,1634373,9.208179,150496,3902448
13,0,1997,56305,43052,25885,96858,3899065,1527884,2.551938,30420,63055,1675928,8.833553,148044,3995923
14,0,1998,57738,51156,26297,99083,4003408,1560722,2.5651,31441,75127,1719248,9.220659,158526,4102491
15,0,1999,60718,49313,26532,106333,4109651,1607300,2.556866,34186,79307,1779663,9.685148,172363,4215984
16,0,2000,63917,54596,26997,102749,4236052,1674523,2.529706669,36920,85875,1835015,8.746086544,160492,4338801
17,0,2001,66525,52872,27934,104464,4340049,1717669,2.52670858,38591,67121,1888179,9.030393834,170510,4444513
18,0,2002,67778,53348,28833,105962,4398747,1743164,2.523429836,38945,21251,1940772,10.18203066,197610,4504709
19,0,2003,69012,46521,28950,106969,4448115,1764982,2.520201316,40062,10313,1991916,11.39264909,226932,4555084
20,0,2004,68452,38609,29025,108262,4500549,1788148,2.516877238,39427,14300,2034030,12.08841561,245882,4608811
21,0,2005,69031,45307,29087,108525,4554009,1811477,2.513975612,39944,13779,2080634,12.9362973,269157,4662534
22,0,2006,69538,44188,29308,111028,4634632,1845956,2.510694729,40230,42896,2122727,13.0384642,276771,4745660
23,0,2007,70777,36353,29653,111911,4709873,1879158,2.506375465,41124,35000,2159545,12.98366091,280388,4821784
24,0,2008,70733,27917,31048,112860,4789078,1914596,2.501351721,39685,40469,2184314,12.34794997,269718,4901938
25,0,2009,69135,18191,30487,113459,4863394,1947695,2.497001069,38648,36267,2203007,11.5892959,255313,4976853
26,1,1985,5210,2741,1304,2256,266508,94949,2.806854,3906,-807,104376,9,9427,268764
27,1,1986,5101,2926,1425,2254,266389,95759,2.781869,3676,-3797,108677,11.9,12918,268643
28,1,1987,5058,943,1540,2261,267062,96564,2.765648,3518,-2838,111852,13.7,15288,269323
29,1,1988,5024,432,1486,2187,266832,97064,2.749032,3538,-3842,112933,14.1,15869,269019
30,1,1989,4777,397,1429,2249,264522,96879,2.730437,3348,-5596,113086,14.3,16207,266771
31,1,1990,4807,335,1561,2727,262981,96353,2.729349,3246,-4309,106947,9.9,10594,265708
32,1,1991,4940,658,1639,2776,270848,98326,2.754592,3301,4615,107282,8.3,8956,273624
33,1,1992,5005,1385,1619,2844,278541,101116,2.754668,3386,4375,108074,6.4,6958,281385
34,1,1993,5034,2439,1693,2880,287897,102836,2.799574,3341,6051,109367,6,6531,290777
35,1,1994,4906,2906,1800,2963,297831,105211,2.830797,3106,6911,111800,5.9,6589,300794
36,1,1995,5063,2944,1781,2979,309614,108485,2.85398,3282,8517,114742,5.5,6257,312593
37,1,1996,5251,2764,1844,3774,319268,111208,2.870908,3407,7042,117691,5.5,6483,323042
38,1,1997,5480,4155,1872,3798,328946,114514,2.87254,3608,6094,120682,5.1,6168,332744
39,1,1998,5846,4478,2053,3795,340229,117449,2.896823,3793,7487,124925,6,7476,344024
40,1,1999,6155,4146,2081,3792,351516,120316,2.921607,4074,7210,129403,7,9087,355308
41,1,2000,6869,1455,2115,3414,348321,124088,2.807048224,4754,-8328,128717,3.596261566,4629,351735
42,1,2001,7132,5819,2223,3396,356041,126724,2.809578296,4909,2793,133917,5.371237408,7193,359437
43,1,2002,7271,6158,2213,3625,367556,130680,2.812641567,5058,6686,139734,6.479453819,9054,371181
44,1,2003,7393,5981,2283,3649,374016,132793,2.816534004,5110,1374,144635,8.187506482,11842,377665
45,1,2004,7429,4811,2216,3643,382302,135443,2.822604343,5213,3067,149648,9.492275206,14205,385945
46,1,2005,7560,5313,2357,3626,391758,138478,2.829026993,5203,4236,154113,10.14515323,15635,395384
47,1,2006,7733,4928,2241,3657,403930,142496,2.834676061,5492,6711,157948,9.782966546,15452,407587
48,1,2007,7841,3252,2279,3671,412244,145208,2.838989587,5562,2766,160651,9.61276307,15443,415915
49,1,2008,7925,2288,2448,3683,421455,148306,2.841793319,5477,3746,162115,8.518027326,13809,425138
50,1,2009,7699,957,2359,3873,432450,152045,2.84422375,5340,5845,162794,6.6028232,10749,436323
51,3,1985,258,10,79,884,12127,4277,2.835399,179,-85,5113,16.4,836,13011
52,3,1986,246,16,84,897,12439,4388,2.834777,162,163,5117,14.2,729,13336
53,3,1987,273,11,90,900,12527,4412,2.839302,183,-92,5126,13.9,714,13427
54,3,1988,264,60,99,1168,12547,4394,2.855485,165,123,5147,14.6,753,13715
55,3,1989,234,28,103,1153,12507,4375,2.858743,131,-186,5293,17.3,918,13660
56,3,1990,265,29,91,998,12632,4721,2.675704,174,-204,5254,10.1,533,13630
57,3,1991,273,20,95,967,12672,4860,2.607407,178,-169,5283,8,423,13639
58,3,1992,273,33,84,1063,12509,4931,2.536808,189,-256,5303,7,372,13572
59,3,1993,228,73,98,817,12840,4983,2.576761,130,-45,5357,7,374,13657
60,3,1994,218,45,98,550,13273,5147,2.578784,120,46,5430,5.2,283,13823
61,3,1995,230,9,126,929,13168,5200,2.532308,104,170,5475,5,275,14097
62,3,1996,236,68,119,795,13527,5391,2.509182,117,108,5651,4.6,260,14322
63,3,1997,235,89,124,876,13602,5500,2.473091,111,45,5719,3.8,219,14478
64,3,1998,242,100,100,916,13707,5603,2.446368,142,3,5808,3.5,205,14623
65,3,1999,203,78,114,956,13866,5700,2.432631,89,110,6019,5.3,319,14822
66,3,2000,231,13,106,995,14104,5523,2.553684592,125,149,6146,10.13667426,623,15099
67,3,2001,249,52,113,995,14236,5598,2.54305109,136,-4,6200,9.709677419,602,15231
68,3,2002,227,92,116,995,14271,5636,2.532114975,111,-76,6246,9.7662504,610,15266
69,3,2003,220,48,131,995,14365,5697,2.521502545,89,5,6299,9.557072551,602,15360
70,3,2004,271,35,101,995,14411,5741,2.510189862,170,-124,6350,9.590551181,609,15406
71,3,2005,260,53,115,995,14400,5757,2.501302762,145,-156,6392,9.934292866,635,15395
72,3,2006,227,64,93,995,14355,5761,2.491754904,134,-179,6417,10.22284557,656,15350
73,3,2007,263,48,114,995,14298,5763,2.480999479,149,-206,6462,10.81708449,699,15293
74,3,2008,258,54,109,995,14351,5808,2.470902204,149,-96,6510,10.78341014,702,15346
75,3,2009,272,56,89,995,14306,5814,2.460612315,183,-228,6536,11.04651163,722,15301
76,5,1985,6458,5069,1602,3536,377708,140787,2.682833,4856,9246,153726,8.4,12939,381244
77,5,1986,6414,4020,1693,3586,383658,144013,2.664051,4721,1279,159313,9.6,15300,387244
78,5,1987,6269,2060,1665,3604,385083,145014,2.655488,4604,-3161,163322,11.2,18308,388687
79,5,1988,6269,1804,1723,3787,382936,144805,2.644494,4546,-6510,165411,12.5,20606,386723
80,5,1989,6200,558,1712,3666,385836,146698,2.630138,4488,-1709,166846,12.1,20148,389502
81,5,1990,6163,637,1829,3112,390172,154710,2.521957,4334,-552,168665,8.3,13955,393284
82,5,1991,6404,1027,1909,3207,399995,159542,2.507145,4495,5423,169302,5.8,9760,403202
83,5,1992,6551,2277,1970,3311,414370,165029,2.510892,4581,9898,170329,3.1,5300,417681
84,5,1993,6407,2905,2036,3383,424087,168215,2.521101,4371,5418,172532,2.5,4317,427470
85,5,1994,6250,4198,2223,3196,433209,171232,2.529953,4027,4908,175437,2.4,4205,436405
86,5,1995,6231,3408,2289,3211,439328,173806,2.527692,3942,2192,179635,3.2,5829,442539
87,5,1996,6343,3585,2281,3190,447875,177697,2.520442,4062,4464,183260,3,5563,451065
88,5,1997,6166,3932,2475,2265,456793,182703,2.500194,3691,4302,186853,2.2,4150,459058
89,5,1998,6504,4234,2534,2243,470156,187217,2.511289,3970,9371,190785,1.9,3568,472399
90,5,1999,6905,5437,2641,3283,478023,191571,2.495279,4264,4643,195845,2.2,4274,481306
91,5,2000,7111,1725,2711,4847,485875,192016,2.530388093,4400,5015,198605,3.317640543,6589,490722
92,5,2001,7526,6900,2909,5193,496478,196308,2.529076757,4617,6332,202264,2.944666377,5956,501671
93,5,2002,7553,7017,2932,5406,505097,199890,2.526874781,4621,4211,208601,4.175914785,8711,510503
94,5,2003,8031,3915,2914,5621,510733,202072,2.527480304,5117,734,213840,5.503179948,11768,516354
95,5,2004,8013,2727,2884,5851,517864,204867,2.527805845,5129,2232,217147,5.655155263,12280,523715
96,5,2005,8088,3070,3014,5643,522571,206663,2.528614217,5074,-575,221982,6.901009992,15319,528214
97,5,2006,8036,3162,2934,5433,530618,209780,2.529402231,5102,2735,226156,7.241019473,16376,536051
98,5,2007,8233,2711,3118,5917,539965,213407,2.530212224,5115,4716,230285,7.329179061,16878,545882
99,5,2008,8292,3023,3207,5773,550473,217507,2.530828893,5085,5279,233100,6.689403689,15593,556246
100,5,2009,8124,1445,3182,5605,560875,220854,2.539573655,4942,5292,236200,6.49703641,15346,566480
101,7,1985,101,9,22,0,5213,1837,2.837779,79,149,3379,45.6,1542,5213
102,7,1986,96,121,40,0,5335,1896,2.813818,56,66,3635,47.8,1739,5335
103,7,1987,88,104,30,0,5265,1884,2.794586,58,-128,3869,51.3,1985,5265
104,7,1988,91,116,42,0,5004,1802,2.776915,49,-310,3979,54.7,2177,5004
105,7,1989,84,68,35,0,5196,1885,2.756499,49,143,4082,53.8,2197,5196
106,7,1990,85,72,30,0,5393,2010,2.683084,55,142,3951,49.1,1941,5393
107,7,1991,73,63,36,0,5626,2076,2.710019,37,196,4023,48.4,1947,5626
108,7,1992,70,107,25,0,5880,2147,2.738705,45,209,4086,47.5,1939,5880
109,7,1993,62,101,35,0,6177,2324,2.657917,27,270,4193,44.6,1869,6177
110,7,1994,77,189,34,0,6539,2456,2.662459,43,319,4294,42.8,1838,6539
111,7,1995,61,248,36,0,7108,2671,2.661175,25,544,4483,40.4,1812,7108
112,7,1996,77,249,36,0,7928,2987,2.654168,41,779,4731,36.9,1744,7928
113,7,1997,99,243,48,0,8534,3239,2.634764,51,555,4980,35,1741,8534
114,7,1998,84,308,41,0,9133,3452,2.645713,43,556,5223,33.9,1771,9133
115,7,1999,106,271,56,0,9570,3619,2.644377,50,387,5536,34.6,1917,9570
116,7,2000,104,87,56,84,9959,4047,2.460835187,48,425,6302,35.78229134,2255,10043
117,7,2001,112,350,60,84,10381,4252,2.441439323,52,370,6667,36.22318884,2415,10465
118,7,2002,126,284,58,84,10616,4384,2.421532847,68,167,6967,37.07478111,2583,10700
119,7,2003,118,365,57,84,10880,4529,2.402296313,61,203,7350,38.38095238,2821,10964
120,7,2004,129,213,64,84,11087,4654,2.382251826,65,142,7582,38.61777895,2928,11171
121,7,2005,109,234,62,84,11318,4790,2.362839248,47,184,7836,38.8718734,3046,11402
122,7,2006,105,247,62,84,11714,4999,2.343268654,43,353,8104,38.31441264,3105,11798
123,7,2007,150,302,78,84,12024,5173,2.324376571,72,238,8428,38.62126246,3255,12108
124,7,2008,130,202,76,84,11990,5204,2.303996925,54,-88,8652,39.85205733,3448,12074
125,7,2009,111,147,94,84,11815,5171,2.284857861,17,-192,8714,40.65871012,3543,11899
126,9,1985,83,1,62,0,4873,1867,2.61007,21,-195,2581,27.7,714,4873
127,9,1986,57,0,56,0,4587,1768,2.594457,1,-287,2603,32.1,835,4587
128,9,1987,74,1,48,0,4559,1763,2.585933,26,-54,2625,32.8,862,4559
129,9,1988,76,1,64,0,4728,1836,2.575163,12,157,2630,30.2,794,4728
130,9,1989,51,3,52,0,4629,1807,2.561704,-1,-98,2587,30.2,780,4629
131,9,1990,61,1,58,74,4452,1872,2.378205,3,-106,2434,23.1,562,4526
132,9,1991,55,3,49,70,4371,1787,2.445999,6,-91,2435,26.6,648,4441
133,9,1992,42,4,58,71,4231,1794,2.358417,-16,-123,2438,26.4,644,4302
134,9,1993,33,3,56,71,4255,1776,2.395833,-23,47,2442,27.3,666,4326
135,9,1994,54,7,54,71,4320,1790,2.413408,0,65,2445,26.8,655,4391
136,9,1995,44,4,56,72,4356,1808,2.409292,-12,49,2452,26.3,644,4428
137,9,1996,58,5,58,74,4452,1855,2.4,0,98,2456,24.5,601,4526
138,9,1997,49,10,58,74,4488,1884,2.382166,-9,45,2461,23.4,577,4562
139,9,1998,53,18,69,74,4457,1873,2.379605,-16,-15,2471,24.2,598,4531
140,9,1999,42,10,63,74,4449,1873,2.375334,-21,13,2489,24.7,616,4523
141,9,2000,55,2,74,85,4414,1901,2.321935823,-19,-4,2360,19.44915254,459,4499
142,9,2001,41,7,67,85,4362,1888,2.310381356,-26,-26,2352,19.72789116,464,4447
143,9,2002,40,7,64,85,4230,1841,2.297664313,-24,-108,2342,21.39197267,501,4315
144,9,2003,35,7,62,85,4173,1827,2.28407225,-27,-30,2333,21.68881269,506,4258
145,9,2004,26,10,53,85,4081,1795,2.273537604,-27,-65,2327,22.86205415,532,4166
146,9,2005,38,9,56,85,4013,1780,2.254494382,-18,-50,2317,23.17652136,537,4098
147,9,2006,37,1,62,85,4003,1784,2.243834081,-25,15,2301,22.46849196,517,4088
148,9,2007,44,0,70,85,3908,1752,2.230593607,-26,-69,2287,23.39309139,535,3993
149,9,2008,45,1,62,85,3821,1721,2.220220802,-17,-70,2273,24.28508579,552,3906
150,9,2009,38,0,69,85,3729,1689,2.207815275,-31,-61,2257,25.16614976,568,3814
151,11,1985,80,6,64,424,5275,1986,2.656093,16,-155,2532,21.6,546,5699
152,11,1986,56,2,66,427,5302,2013,2.63388,-10,40,2548,21,535,5729
153,11,1987,65,7,55,407,5025,1923,2.613105,10,-307,2561,24.9,638,5432
154,11,1988,76,3,71,405,5027,1938,2.593911,5,-5,2571,24.6,633,5432
155,11,1989,64,1,48,331,4879,1895,2.57467,16,-238,2574,26.4,679,5210
156,11,1990,60,2,67,372,4655,1865,2.495979,-7,-176,2332,20,467,5027
157,11,1991,59,1,66,366,4594,1836,2.502179,-7,-60,2334,21.3,498,4960
158,11,1992,48,2,51,369,4671,1853,2.520777,-3,83,2335,20.6,482,5040
159,11,1993,63,5,43,603,4747,1914,2.480146,20,290,2337,18.1,423,5350
160,11,1994,59,12,45,709,4691,1896,2.474156,14,36,2342,19,446,5400
161,11,1995,78,19,74,735,4814,1954,2.463664,4,145,2354,17,400,5549
162,11,1996,70,52,73,1072,4551,1865,2.440214,-3,77,2373,21.4,508,5623
163,11,1997,56,15,70,1479,4161,1730,2.405202,-14,31,2425,28.7,695,5640
164,11,1998,72,23,74,1846,4147,1734,2.39158,-2,355,2440,28.9,706,5993
165,11,1999,82,14,62,2213,3783,1591,2.37775,20,-17,2463,35.4,872,5996
166,11,2000,66,4,65,926,5041,1994,2.528084253,1,-35,2365,15.68710359,371,5967
167,11,2001,69,17,64,878,5004,1995,2.508270677,5,-90,2362,15.53767993,367,5882
168,11,2002,66,12,78,1067,5136,2063,2.489578284,-12,333,2353,12.32469188,290,6203
169,11,2003,62,11,66,1408,5245,2123,2.470560528,-4,454,2343,9.389671362,220,6653
170,11,2004,63,0,64,1505,4852,1979,2.451743305,-1,-295,2323,14.80843737,344,6357
171,11,2005,63,10,49,1565,4696,1931,2.43190057,14,-110,2312,16.47923875,381,6261
172,11,2006,60,9,72,1553,4523,1874,2.413553895,-12,-173,2300,18.52173913,426,6076
173,11,2007,68,4,56,1525,4248,1773,2.395939086,12,-315,2285,22.40700219,512,5773
174,11,2008,64,7,73,1760,4248,1789,2.3745109,-9,244,2271,21.22413034,482,6008
175,11,2009,63,5,69,2216,4265,1810,2.356353591,-6,479,2255,19.73392461,445,6481
176,13,1985,3326,1953,1064,8600,200844,79100,2.539115,2262,-3005,88178,10.3,9078,209444
177,13,1986,3272,1944,1007,8729,203112,80731,2.515911,2265,132,90087,10.4,9356,211841
178,13,1987,3251,1626,1061,8780,205442,82203,2.499203,2190,191,92060,10.7,9857,214222
179,13,1988,3231,925,1071,9384,208996,84226,2.481372,2160,1998,93728,10.1,9502,218380
180,13,1989,3230,1056,1065,10854,211500,85911,2.46185,2165,1809,94466,9.1,8555,222354
181,13,1990,3320,1375,1094,8640,217374,88402,2.458926,2226,1434,94621,6.6,6219,226014
182,13,1991,3323,1478,1104,9097,221880,89867,2.468982,2219,2744,96048,6.4,6181,230977
183,13,1992,3332,2734,1043,9266,229131,93100,2.461128,2289,5131,97631,4.6,4531,238397
184,13,1993,3228,2684,1191,9561,237714,96796,2.455825,2037,6841,100204,3.4,3408,247275
185,13,1994,3166,2191,1205,9469,243256,98566,2.46795,1961,3489,102888,4.2,4322,252725
186,13,1995,3050,2938,1281,9606,247894,100377,2.46963,1769,3006,105055,4.5,4678,257500
187,13,1996,3199,2588,1242,9561,252204,102053,2.471304,1957,2308,107800,5.3,5747,261765
188,13,1997,3182,3062,1352,9328,256735,104480,2.457265,1830,2468,110475,5.4,5995,266063
189,13,1998,3377,4687,1343,9514,264601,107096,2.47069,2034,6018,113224,5.4,6128,274115
190,13,1999,3513,2780,1369,9700,274224,109720,2.499307,2144,7665,117952,7,8232,283924
191,13,2000,3719,621,1388,8506,267749,109578,2.443455803,2331,-10004,114121,3.980862418,4543,276255
192,13,2001,3833,2483,1444,8794,274716,112448,2.443049232,2389,4866,116588,3.550965794,4140,283510
193,13,2002,3829,2230,1403,8906,275527,112904,2.440365266,2426,-1503,118445,4.678120647,5541,284433
194,13,2003,3636,1775,1474,8883,273880,112395,2.436763201,2162,-3832,120272,6.549321538,7877,282763
195,13,2004,3571,1606,1434,8600,274688,112905,2.432912626,2137,-1612,121715,7.238220433,8810,283288
196,13,2005,3510,1771,1378,8562,274348,112978,2.42833118,2132,-2510,123133,8.247179879,10155,282910
197,13,2006,3511,1427,1471,9931,276202,113945,2.423994032,2040,1183,124311,8.338763263,10366,286133
198,13,2007,3390,953,1481,9809,278948,115320,2.41890392,1909,715,125261,7.936229154,9941,288757
199,13,2008,3353,701,1524,9935,281892,116788,2.413706888,1829,1241,125999,7.310375479,9211,291827
200,13,2009,3187,1044,1512,9879,283762,117841,2.4080074,1675,139,126756,7.03319764,8915,293641
201,14,1985,0,0,0,0,0,0,0,0,0,0,0,0,0
202,14,1986,0,0,0,0,0,0,0,0,0,0,0,0,0
203,14,1987,0,0,0,0,0,0,0,0,0,0,0,0,0
204,14,1988,0,0,0,0,0,0,0,0,0,0,0,0,0
205,14,1989,0,0,0,0,0,0,0,0,0,0,0,0,0
206,14,1990,0,0,0,0,0,0,0,0,0,0,0,0,0
207,14,1991,0,0,0,0,0,0,0,0,0,0,0,0,0
208,14,1992,0,0,0,0,0,0,0,0,0,0,0,0,0
209,14,1993,0,0,0,0,0,0,0,0,0,0,0,0,0
210,14,1994,0,0,0,0,0,0,0,0,0,0,0,0,0
211,14,1995,0,0,0,0,0,0,0,0,0,0,0,0,0
212,14,1996,0,0,0,0,0,0,0,0,0,0,0,0,0
213,14,1997,0,0,0,0,0,0,0,0,0,0,0,0,0
214,14,1998,0,0,0,0,0,0,0,0,0,0,0,0,0
215,14,1999,0,0,0,0,0,0,0,0,0,0,0,0,0
216,14,2000,0,112,0,7,38537,13949,2.762707004,0,38544,14450,3.467128028,501,38544
217,14,2001,0,446,0,7,41380,15071,2.745670493,0,2843,15056,-0.099628055,-15,41387
218,14,2002,421,1070,116,7,42425,15548,2.728646771,305,740,15881,2.096845287,333,42432
219,14,2003,689,856,190,7,44953,16578,2.711605743,499,2029,16800,1.321428571,222,44960
220,14,2004,604,621,208,7,46399,17219,2.694639642,396,1050,17548,1.874857534,329,46406
221,14,2005,649,715,193,7,48244,18018,2.677544678,456,1389,18778,4.047289381,760,48251
222,14,2006,676,742,228,7,51145,19223,2.660614888,448,2453,19729,2.564752395,506,51152
223,14,2007,722,1027,231,7,53321,20170,2.643579574,491,1685,20727,2.687316061,557,53328
224,14,2008,723,1006,230,7,54393,20709,2.626539186,493,579,21472,3.553464978,763,54400
225,14,2009,693,794,244,7,55371,21219,2.609500919,449,529,22327,4.962601335,1108,55378
226,15,1985,156,73,107,612,11737,4543,2.583535,49,-538,6402,29,1859,12349
227,15,1986,169,39,136,620,11853,4617,2.567251,33,91,6473,28.7,1856,12473
228,15,1987,129,49,107,620,11833,4632,2.55462,22,-42,6511,28.9,1879,12453
229,15,1988,148,58,120,923,11467,4434,2.586153,28,-91,6572,32.5,2138,12390
230,15,1989,132,42,121,1128,11431,4532,2.522286,11,158,6575,31.1,2043,12559
231,15,1990,133,36,107,1158,11548,4848,2.382013,26,121,6547,26,1699,12706
232,15,1991,125,104,117,1230,11634,5027,2.314303,8,150,6583,23.6,1556,12864
233,15,1992,112,83,155,1288,11833,5108,2.316562,-43,300,6687,23.6,1579,13121
234,15,1993,128,117,142,1535,12165,5176,2.350271,-14,593,6770,23.5,1594,13700
235,15,1994,127,182,157,1314,12793,5438,2.352519,-30,437,6887,21,1449,14107
236,15,1995,115,211,121,1248,13408,5719,2.344466,-6,555,7069,19.1,1350,14656
237,15,1996,111,253,139,1291,13834,5932,2.332097,-28,497,7280,18.5,1348,15125
238,15,1997,132,166,162,1331,14075,6102,2.306621,-30,311,7533,19,1431,15406
239,15,1998,143,197,144,1351,14175,6147,2.306003,-1,121,7699,20.2,1552,15526
240,15,1999,138,218,126,1371,14565,6350,2.293701,12,398,7914,19.8,1564,15936
241,15,2000,137,56,134,1363,14949,6623,2.257134229,3,374,8449,21.61202509,1826,16312
242,15,2001,157,224,146,1337,15073,6707,2.247353511,11,87,8660,22.55196305,1953,16410
243,15,2002,139,213,162,1333,15313,6844,2.237434249,-23,259,8840,22.57918552,1996,16646
244,15,2003,137,241,137,1360,15434,6928,2.227771363,0,148,9060,23.53200883,2132,16794
245,15,2004,147,196,147,1332,15614,7041,2.21758273,0,152,9243,23.82343395,2202,16946
246,15,2005,151,164,140,1338,15684,7109,2.206217471,11,65,9419,24.52489649,2310,17022
247,15,2006,142,151,162,1336,15648,7127,2.195594219,-20,-18,9549,25.36391245,2422,16984
248,15,2007,132,154,153,1408,15830,7247,2.184352146,-21,275,9725,25.48071979,2478,17238
249,15,2008,130,209,169,1337,16066,7391,2.1737248,-39,204,9943,25.6662979,2552,17403
250,15,2009,156,130,143,1366,16238,7507,2.163047822,13,188,9988,24.83980777,2481,17604
251,17,1985,55,3,21,14,2280,965,2.362694,34,23,1060,9,95,2294
252,17,1986,35,2,24,13,2172,937,2.318036,11,-120,1090,14,153,2185
253,17,1987,37,1,27,13,2084,919,2.267682,10,-98,1119,17.9,200,2097
254,17,1988,48,5,26,14,2194,985,2.227411,22,89,1122,12.2,137,2208
255,17,1989,46,2,35,15,2299,1021,2.251714,11,95,1128,9.5,107,2314
256,17,1990,26,4,22,45,2368,904,2.619469,4,95,1083,16.5,179,2413
257,17,1991,40,2,24,40,2436,818,2.977995,16,47,1087,24.7,269,2476
258,17,1992,41,3,22,45,2362,910,2.595604,19,-88,1089,16.4,179,2407
259,17,1993,36,5,21,44,2262,886,2.553047,15,-116,1092,18.9,206,2306
260,17,1994,20,4,21,44,2247,885,2.538983,-1,-14,1097,19.3,212,2291
261,17,1995,29,2,17,44,2225,880,2.528409,12,-34,1101,20.1,221,2269
262,17,1996,33,2,21,45,2239,893,2.507279,12,3,1103,19,210,2284
263,17,1997,19,6,26,46,2249,910,2.471429,-7,18,1105,17.6,195,2295
264,17,1998,30,2,26,46,2297,935,2.456685,4,44,1111,15.8,176,2343
265,17,1999,32,3,23,46,2233,916,2.437773,9,-73,1113,17.7,197,2279
266,17,2000,23,1,15,30,2186,876,2.49543379,8,-68,1103,20.58023572,227,2216
267,17,2001,17,3,15,30,2143,865,2.477456647,2,-45,1090,20.64220183,225,2173
268,17,2002,28,4,20,30,2132,869,2.453394707,8,-19,1078,19.3877551,209,2162
269,17,2003,21,0,32,30,2089,861,2.426248548,-11,-32,1064,19.07894737,203,2119
270,17,2004,17,1,28,30,2040,847,2.40850059,-11,-38,1050,19.33333333,203,2070
271,17,2005,22,3,27,30,2011,844,2.382701422,-5,-24,1038,18.68978805,194,2041
272,17,2006,21,3,21,30,1947,823,2.365735115,0,-64,1026,19.78557505,203,1977
273,17,2007,26,1,14,30,1880,801,2.347066167,12,-79,1013,20.92793682,212,1910
274,17,2008,24,0,19,30,1868,804,2.323383085,5,-17,999,19.51951952,195,1898
275,17,2009,22,0,34,30,1803,785,2.296815287,-12,-53,985,20.30456853,200,1833
276,19,1985,140,53,40,45,7891,3093,2.551245,100,84,4596,32.7,1503,7936
277,19,1986,123,35,37,46,8113,3184,2.548053,86,137,4647,31.5,1463,8159
278,19,1987,131,39,26,44,7778,3055,2.54599,105,-442,4681,34.7,1626,7822
279,19,1988,112,18,33,43,7684,3024,2.541005,79,-174,4724,36,1700,7727
280,19,1989,115,18,35,42,7625,3006,2.536593,80,-140,4839,37.9,1833,7667
281,19,1990,105,23,34,45,7568,3153,2.400254,71,-125,4811,34.5,1658,7613
282,19,1991,108,22,32,41,7612,2972,2.561238,76,-36,4834,38.5,1862,7653
283,19,1992,114,65,34,44,7798,3132,2.489783,80,109,4856,35.5,1724,7842
284,19,1993,114,69,37,47,7990,3324,2.40373,77,118,4921,32.5,1597,8037
285,19,1994,118,81,44,50,8408,3485,2.412626,74,347,4990,30.2,1505,8458
286,19,1995,117,83,54,50,8634,3579,2.412406,63,163,5071,29.4,1492,8684
287,19,1996,122,93,50,50,8666,3606,2.403217,72,-40,5154,30,1548,8716
288,19,1997,103,83,36,51,8829,3700,2.386216,67,97,5247,29.5,1547,8880
289,19,1998,101,102,36,51,8947,3750,2.385867,65,53,5330,29.6,1580,8998
290,19,1999,116,88,42,51,9132,3827,2.386203,74,111,5432,29.5,1605,9183
291,19,2000,110,14,39,42,9319,4050,2.300987654,71,104,5175,21.73913043,1125,9361
292,19,2001,118,56,38,42,9422,4122,2.2857836,80,23,5245,21.41086749,1123,9464
293,19,2002,108,63,50,42,9424,4151,2.270296314,58,-56,5313,21.87088274,1162,9466
294,19,2003,92,71,48,42,9475,4200,2.255952381,44,7,5382,21.96209588,1182,9517
295,19,2004,102,56,44,42,9419,4203,2.24101832,58,-114,5461,23.03607398,1258,9461
296,19,2005,99,41,60,42,9350,4203,2.224601475,39,-108,5511,23.73434948,1308,9392
297,19,2006,121,34,42,42,9237,4179,2.210337401,79,-192,5545,24.63480613,1366,9279
298,19,2007,82,33,57,42,9291,4233,2.194897236,25,29,5596,24.35668335,1363,9333
299,19,2008,99,22,43,42,9252,4243,2.180532642,56,-95,5638,24.7428166,1395,9294
300,19,2009,76,15,43,42,9018,4165,2.165186074,33,-267,5664,26.46539548,1499,9060
301,21,1985,143,1,60,0,7776,2486,3.127916,83,-312,3316,25,830,7776
302,21,1986,137,0,79,0,7947,2576,3.085016,58,113,3313,22.2,737,7947
303,21,1987,137,4,71,0,8090,2649,3.053983,66,77,3310,20,661,8090
304,21,1988,133,1,49,0,7854,2599,3.021931,84,-320,3318,21.7,719,7854
305,21,1989,137,0,63,0,7623,2553,2.985899,74,-305,3309,22.8,756,7623
306,21,1990,128,1,54,30,7421,2492,2.977929,74,-246,3574,30.3,1082,7451
307,21,1991,111,0,54,28,7506,2378,3.156434,57,26,3575,33.5,1197,7534
308,21,1992,113,1,82,29,7485,2443,3.063856,31,-51,3575,31.7,1132,7514
309,21,1993,127,0,63,30,7612,2518,3.023034,64,64,3576,29.6,1058,7642
310,21,1994,116,4,71,31,7724,2543,3.037358,45,68,3581,29,1038,7755
311,21,1995,116,1,76,31,7875,2582,3.049961,40,111,3585,28,1003,7906
312,21,1996,132,168,70,31,7988,2615,3.054684,62,51,3586,27.1,971,8019
313,21,1997,128,166,66,32,8068,2651,3.04338,62,19,3754,29.4,1103,8100
314,21,1998,134,175,84,32,8155,2670,3.054307,50,37,3920,31.9,1250,8187
315,21,1999,121,181,72,32,8276,2698,3.067457,49,72,3888,30.6,1190,8308
316,21,2000,142,0,85,53,8355,2989,2.795249247,57,38,3887,23.10264986,898,8408
317,21,2001,133,0,72,53,8312,2990,2.77993311,61,-104,3886,23.05712815,896,8365
318,21,2002,105,0,74,53,8336,3015,2.764842454,31,-7,3887,22.43375354,872,8389
319,21,2003,109,198,75,53,8334,3032,2.748680739,34,-36,4084,25.75905975,1052,8387
320,21,2004,122,29,75,53,8448,3093,2.731328807,47,67,4112,24.7811284,1019,8501
321,21,2005,123,46,72,53,8447,3111,2.715204114,51,-52,4157,25.16237671,1046,8500
322,21,2006,116,36,64,53,8417,3120,2.69775641,52,-82,4193,25.5902695,1073,8470
323,21,2007,127,37,74,53,8380,3123,2.683317323,53,-90,4228,26.13528855,1105,8433
324,21,2008,123,28,77,53,8331,3123,2.667627281,46,-95,4257,26.6384778,1134,8384
325,21,2009,113,14,79,53,8157,3079,2.649236765,34,-208,4274,27.95975667,1195,8210
326,23,1985,50,0,20,0,3363,1167,2.881748,30,73,1614,27.7,447,3363
327,23,1986,39,0,36,0,3307,1158,2.855786,3,-59,1640,29.4,482,3307
328,23,1987,57,0,24,0,3349,1181,2.835732,33,9,1667,29.2,486,3349
329,23,1988,43,0,23,0,3397,1207,2.814416,20,28,1671,27.8,464,3397
330,23,1989,54,0,21,0,3277,1175,2.788936,33,-153,1600,26.6,425,3277
331,23,1990,40,0,29,2,3191,1192,2.677013,11,-95,1743,31.6,551,3193
332,23,1991,40,0,23,0,3256,1137,2.863676,17,46,1743,34.8,606,3256
333,23,1992,45,0,24,2,3188,1196,2.665552,21,-87,1743,31.4,547,3190
334,23,1993,44,0,38,2,3335,1223,2.726901,6,141,2133,42.7,910,3337
335,23,1994,50,0,33,2,3374,1224,2.756536,17,22,2133,42.6,909,3376
336,23,1995,58,0,36,2,3509,1265,2.773913,22,113,2133,40.7,868,3511
337,23,1996,42,0,39,2,3579,1290,2.774419,3,67,2133,39.5,843,3581
338,23,1997,47,0,46,2,3639,1314,2.769406,1,59,2133,38.4,819,3641
339,23,1998,40,0,37,2,3698,1329,2.782543,3,56,2133,37.7,804,3700
340,23,1999,50,0,36,2,3677,1314,2.798326,14,-35,2133,38.4,819,3679
341,23,2000,40,0,37,0,3674,1511,2.431502316,3,-9,2211,31.65988241,700,3674
342,23,2001,47,0,38,0,3741,1547,2.41822883,9,58,2244,31.06060606,697,3741
343,23,2002,47,0,33,0,3734,1557,2.39820167,14,-21,2278,31.65057068,721,3734
344,23,2003,48,0,46,0,3800,1594,2.383939774,2,64,2300,30.69565217,706,3800
345,23,2004,29,0,51,0,3802,1605,2.368847352,-22,24,2330,31.11587983,725,3802
346,23,2005,39,25,34,0,3695,1570,2.353503185,5,-112,2373,33.83902233,803,3695
347,23,2006,39,23,39,0,3698,1583,2.336070752,0,3,2426,34.7485573,843,3698
348,23,2007,29,19,32,0,3676,1585,2.319242902,-3,-19,2473,35.90780429,888,3676
349,23,2008,31,17,38,0,3611,1569,2.301465902,-7,-58,2523,37.81212842,954,3611
350,23,2009,33,12,29,0,3505,1533,2.286366601,4,-110,2584,40.67337461,1051,3505
351,25,1985,51,1,36,53,2944,1262,2.332805,15,94,1309,3.6,47,2997
352,25,1986,51,3,42,53,2932,1288,2.276397,9,-21,1310,1.7,22,2985
353,25,1987,42,42,33,56,3016,1341,2.249068,9,78,1362,1.5,21,3072
354,25,1988,41,1,31,945,2897,1340,2.16194,10,760,1405,4.6,65,3842
355,25,1989,32,1,48,1070,2831,1322,2.141452,-16,75,1405,5.9,83,3901
356,25,1990,49,1,27,1031,2898,1165,2.487554,22,6,1415,17.7,250,3929
357,25,1991,50,1,26,1052,2921,1175,2.485957,24,20,1416,17,241,3973
358,25,1992,46,0,38,1089,3051,1224,2.492647,8,159,1417,13.6,193,4140
359,25,1993,40,0,46,1081,3064,1223,2.505315,-6,11,1417,13.7,194,4145
360,25,1994,29,1,56,1135,3072,1240,2.477419,-27,89,1417,12.5,177,4207
361,25,1995,51,1,37,1078,3143,1289,2.438324,14,0,1418,9.1,129,4221
362,25,1996,48,2,49,1140,3126,1324,2.361027,-1,46,1419,6.7,95,4266
363,25,1997,44,2,37,1184,3119,1338,2.331091,7,30,1442,7.2,104,4303
364,25,1998,52,2,51,1177,3109,1350,2.302963,1,-18,1444,6.5,94,4286
365,25,1999,48,4,38,1920,3078,1467,2.09816,10,702,1539,4.7,72,4998
366,25,2000,45,5,34,1590,3540,1369,2.585829072,11,117,1546,11.44890039,177,5130
367,25,2001,41,19,39,1842,3411,1327,2.570459683,2,121,1561,14.99039078,234,5253
368,25,2002,42,3,49,1975,3369,1319,2.554207733,-7,98,1561,15.50288277,242,5344
369,25,2003,43,2,49,1850,3306,1305,2.533333333,-6,-182,1560,16.34615385,255,5156
370,25,2004,53,1,55,2125,3307,1316,2.512917933,-2,278,1558,15.53273427,242,5432
371,25,2005,40,4,48,2240,3197,1281,2.495706479,-8,13,1560,17.88461538,279,5437
372,25,2006,35,5,47,2580,3133,1264,2.478639241,-12,288,1561,19.02626521,297,5713
373,25,2007,28,0,45,2865,3042,1238,2.457189015,-17,211,1559,20.59012187,321,5907
374,25,2008,31,8,40,2925,2968,1217,2.438783895,-9,-5,1562,22.08706786,345,5893
375,25,2009,44,0,47,2938,2865,1184,2.419763514,-3,-87,1561,24.15118514,377,5803
376,27,1985,22,0,22,18,2048,823,2.488457,0,160,1300,36.7,477,2066
377,27,1986,26,1,18,18,2057,839,2.451728,8,1,1304,35.7,465,2075
378,27,1987,25,1,6,18,2032,839,2.421931,19,-44,1310,36,471,2050
379,27,1988,17,14,12,17,1959,821,2.386115,5,-79,1313,37.5,492,1976
380,27,1989,24,0,15,17,1930,821,2.350792,9,-38,1336,38.5,515,1947
381,27,1990,13,0,6,1,1943,770,2.523377,7,-10,2216,65.3,1446,1944
382,27,1991,13,37,12,1,2011,832,2.417067,1,67,2216,62.5,1384,2012
383,27,1992,28,44,19,1,2140,941,2.274176,9,120,2253,58.2,1312,2141
384,27,1993,19,66,22,1,2322,945,2.457143,-3,185,2297,58.9,1352,2323
385,27,1994,36,87,14,1,2417,986,2.451319,22,73,2363,58.3,1377,2418
386,27,1995,34,92,12,1,2617,1075,2.434419,22,178,2450,56.1,1375,2618
387,27,1996,35,81,24,1,2847,1182,2.408629,11,219,2542,53.5,1360,2848
388,27,1997,30,218,13,1,3056,1286,2.376361,17,192,2623,51,1337,3057
389,27,1998,35,137,14,1,3174,1343,2.363366,21,97,2841,52.7,1498,3175
390,27,1999,34,90,21,1,3363,1434,2.345188,13,176,2978,51.8,1544,3364
391,27,2000,35,35,21,16,3504,1491,2.350100604,14,149,3029,50.77583361,1538,3520
392,27,2001,30,139,15,16,3714,1595,2.328526646,15,195,3079,48.19746671,1484,3730
393,27,2002,31,115,27,16,3767,1633,2.306797306,4,49,3157,48.27367754,1524,3783
394,27,2003,25,162,28,16,3918,1715,2.284548105,-3,154,3249,47.21452755,1534,3934
395,27,2004,36,126,21,16,3968,1755,2.260968661,15,35,3313,47.02686387,1558,3984
396,27,2005,24,106,30,16,4029,1800,2.238333333,-6,67,3442,47.70482278,1642,4045
397,27,2006,15,100,33,16,4001,1806,2.215393134,-18,-10,3573,49.45424013,1767,4017
398,27,2007,23,85,26,16,4114,1873,2.196476241,-3,116,3696,49.32359307,1823,4130
399,27,2008,26,69,26,16,4103,1888,2.173199153,0,-11,3797,50.27653411,1909,4119
400,27,2009,24,51,39,16,4150,1931,2.14914552,-15,62,3888,50.33436214,1957,4166
401,29,1985,323,10,245,331,23135,9237,2.504601,78,-617,9974,7.4,737,23466
402,29,1986,290,-6,222,316,22037,8903,2.475233,68,-1181,9689,8.1,786,22353
403,29,1987,259,3,266,309,21473,8770,2.448461,-7,-564,9387,6.6,617,21782
404,29,1988,236,-3,248,351,21151,8735,2.421408,-12,-268,9402,7.1,667,21502
405,29,1989,241,-1,265,366,20839,8718,2.390342,-24,-273,9397,7.2,679,21205
406,29,1990,227,3,271,500,20491,8372,2.447563,-44,-170,10082,17,1710,20991
407,29,1991,236,4,264,652,20577,8635,2.382976,-28,266,10085,14.4,1450,21229
408,29,1992,280,40,270,688,21181,9070,2.335281,10,630,10089,10.1,1019,21869
409,29,1993,268,39,257,555,22678,9248,2.452206,11,1353,10159,9,911,23233
410,29,1994,274,54,284,716,23627,9580,2.466284,-10,1120,10453,8.4,873,24343
411,29,1995,306,47,292,719,24474,9902,2.471622,14,836,10507,5.8,605,25193
412,29,1996,300,59,319,877,24841,10050,2.471741,-19,544,10557,4.8,507,25718
413,29,1997,298,39,311,1121,24884,10143,2.453318,-13,300,10616,4.5,473,26005
414,29,1998,309,75,296,1208,25613,10296,2.487665,13,803,10655,3.4,359,26821
415,29,1999,299,94,317,1295,26105,10413,2.506963,-18,597,10730,3,317,27400
416,29,2000,296,23,330,916,26993,11098,2.432240043,-34,535,12410,10.57211926,1312,27909
417,29,2001,316,91,314,929,27458,11312,2.427333805,2,476,12685,10.82380765,1373,28387
418,29,2002,317,27,339,923,27855,11500,2.422173913,-22,413,12926,11.03202847,1426,28778
419,29,2003,344,41,329,890,28171,11657,2.416659518,15,268,13175,11.52182163,1518,29061
420,29,2004,330,73,299,923,28530,11833,2.411053833,31,361,13453,12.04192373,1620,29453
421,29,2005,336,92,336,934,28478,11838,2.405642845,0,-41,13733,13.79887861,1895,29412
422,29,2006,346,113,303,935,28767,11984,2.400450601,43,247,14040,14.64387464,2056,29702
423,29,2007,353,143,323,909,28968,12095,2.395039272,30,145,14265,15.21205748,2170,29877
424,29,2008,369,110,351,914,29428,12310,2.390576767,18,447,14439,14.74478842,2129,30342
425,29,2009,329,91,358,935,29690,12451,2.384547426,-29,312,14516,14.22568201,2065,30625
426,31,1985,8952,1272,4541,13031,483400,226540,2.13384,4411,-4595,238346,5,11806,496431
427,31,1986,9183,2417,4624,13117,483897,230128,2.10273,4559,-3976,239660,4,9532,497014
428,31,1987,8856,1109,4509,13044,477230,229863,2.07615,4347,-11087,242120,5.1,12257,490274
429,31,1988,8375,434,4458,13081,466541,227410,2.051541,3917,-14569,243234,6.5,15824,479622
430,31,1989,8252,512,4415,12812,459973,227897,2.018337,3837,-10674,243525,6.4,15628,472785
431,31,1990,8633,-58,4389,10850,457004,210952,2.166389,4244,-9175,239636,12,28684,467854
432,31,1991,8548,-104,4450,11489,463694,216613,2.140656,4098,3231,239578,9.6,22965,475183
433,31,1992,8807,283,4565,11751,476507,222322,2.143319,4242,8833,239474,7.2,17152,488258
434,31,1993,8611,785,4670,12158,489177,221386,2.209611,3941,9136,239757,7.7,18371,501335
435,31,1994,8401,1661,4711,11631,492618,221418,2.224833,3690,-776,240542,8,19124,504249
436,31,1995,8062,786,4886,11792,495931,222532,2.228583,3176,298,242644,8.3,20112,507723
437,31,1996,8349,1432,4731,11005,507250,225615,2.248299,3618,6914,243430,7.3,17815,518255
438,31,1997,8594,2261,4684,10214,517228,229556,2.253167,3910,5277,244862,6.3,15306,527442
439,31,1998,8608,4689,4648,10096,523310,231418,2.261319,3960,2004,247123,6.4,15705,533406
440,31,1999,9183,3379,4483,13382,532135,240788,2.209973,4700,7411,252354,4.6,11566,545517
441,31,2000,9544,887,4390,12719,544019,240360,2.263350807,5154,6069,252392,4.76718755,12032,556738
442,31,2001,10297,3546,4310,12922,550378,243645,2.258934105,5987,575,256223,4.909005046,12578,563300
443,31,2002,10278,4338,4444,12986,546104,242226,2.254522636,5834,-10044,260857,7.142227351,18631,559090
444,31,2003,10404,4491,4234,13123,547225,243200,2.250102796,6170,-4912,265654,8.452347791,22454,560348
445,31,2004,10269,2958,4318,13353,546877,243523,2.245689319,5951,-6069,268921,9.444409325,25398,560230
446,31,2005,10436,3993,4278,13355,546104,243658,2.241272603,6158,-6929,273126,10.78915958,29468,559459
447,31,2006,10134,3047,4194,13367,549495,245655,2.236856567,5940,-2537,276569,11.1776808,30914,562862
448,31,2007,10084,3655,4134,13245,557192,249588,2.232447073,5950,1625,280158,10.91169983,30570,570437
449,31,2008,10169,3494,4183,13223,568680,255239,2.228029416,5986,5480,281076,9.192175782,25837,581903
450,31,2009,10184,3053,4134,13308,582265,261855,2.223616123,6050,7620,283636,7.679208563,21781,595573
451,33,1985,27,0,9,0,1548,571,2.711033,18,-154,916,37.7,345,1548
452,33,1986,20,0,11,0,1529,571,2.677758,9,-28,945,39.6,374,1529
453,33,1987,29,0,13,0,1494,562,2.658363,16,-51,974,42.3,412,1494
454,33,1988,24,0,11,0,1591,604,2.634106,13,84,976,38.1,372,1591
455,33,1989,18,0,17,0,1541,591,2.607445,1,-51,1009,41.4,418,1541
456,33,1990,17,0,10,0,1489,581,2.562823,7,-59,947,38.6,366,1489
457,33,1991,16,6,13,0,1437,537,2.675978,3,-55,947,43.3,410,1437
458,33,1992,18,4,13,0,1403,502,2.794821,5,-39,953,47.3,451,1403
459,33,1993,16,8,13,0,1426,559,2.550984,3,20,957,41.6,398,1426
460,33,1994,13,5,8,0,1499,588,2.54932,5,68,970,39.4,382,1499
461,33,1995,18,12,21,0,1566,617,2.538088,-3,70,975,36.7,358,1566
462,33,1996,23,6,14,0,1636,649,2.520801,9,61,987,34.2,338,1636
463,33,1997,24,3,16,0,1674,673,2.48737,8,30,993,32.2,320,1674
464,33,1998,13,6,9,0,1766,713,2.476858,4,88,996,28.4,283,1766
465,33,1999,16,6,22,0,1811,735,2.463946,-6,51,1002,26.6,267,1811
466,33,2000,21,2,18,0,1849,788,2.346446701,3,36,1200,34.33333333,412,1849
467,33,2001,22,7,19,0,1865,796,2.342964824,3,13,1226,35.07340946,430,1865
468,33,2002,22,8,21,0,1880,805,2.335403727,1,14,1254,35.80542265,449,1880
469,33,2003,20,9,24,0,1879,807,2.328376704,-4,3,1283,37.1005456,476,1879
470,33,2004,23,7,19,0,1873,805,2.326708075,4,-10,1312,38.64329268,507,1873
471,33,2005,21,6,11,0,1888,814,2.319410319,10,5,1338,39.16292975,524,1888
472,33,2006,22,6,20,0,1990,860,2.313953488,2,100,1367,37.088515,507,1990
473,33,2007,27,5,20,0,2001,867,2.307958478,7,4,1394,37.80487805,527,2001
474,33,2008,30,3,19,0,2074,900,2.304444444,11,62,1422,36.70886076,522,2074
475,33,2009,28,1,16,0,2052,892,2.30044843,12,-34,1448,38.39779006,556,2052
476,35,1985,679,2160,129,163,39885,11824,3.373224,550,3214,15225,22.3,3401,40048
477,35,1986,772,2370,122,169,45485,13530,3.361789,650,4956,17810,24,4280,45654
478,35,1987,853,1825,133,178,48666,14345,3.392541,720,2470,20189,28.9,5844,48844
479,35,1988,991,1604,171,191,52936,15439,3.42872,820,3463,22017,29.9,6578,53127
480,35,1989,1129,1475,162,201,56963,16649,3.421407,967,3070,23622,29.5,6973,57164
481,35,1990,1208,1587,144,217,61342,20844,2.942909,1064,3331,22291,6.5,1447,61559
482,35,1991,1311,1916,159,239,66449,23010,2.887831,1152,3977,23878,3.6,868,66688
483,35,1992,1369,2946,190,271,75090,25714,2.920199,1179,7494,25794,0.3,80,75361
484,35,1993,1483,3295,222,295,82837,28231,2.934257,1261,6510,28810,2,579,83132
485,35,1994,1617,4045,262,332,92194,31588,2.91864,1355,8039,32229,2,641,92526
486,35,1995,1719,4785,239,364,103475,35498,2.914953,1480,9833,36274,2.1,776,103839
487,35,1996,1981,5732,251,395,114318,39371,2.903609,1730,9144,41059,4.1,1688,114713
488,35,1997,2281,5564,329,442,128889,44778,2.8784,1952,12666,46739,4.2,1961,129331
489,35,1998,2525,6443,350,442,143912,49767,2.891715,2175,12848,52303,4.8,2536,144354
490,35,1999,2897,7166,399,442,161881,55522,2.915619,2498,15471,58385,4.9,2863,162323
491,35,2000,3281,1557,438,654,179856,62610,2.872640153,2843,15343,65623,4.591378023,3013,180510
492,35,2001,3648,6227,490,654,198384,69278,2.86359306,3158,15370,72898,4.965842684,3620,199038
493,35,2002,3765,5914,505,654,209051,73226,2.854873952,3260,7407,79062,7.381548658,5836,209705
494,35,2003,3999,4397,534,661,220485,77472,2.845995973,3465,7976,84225,8.017809439,6753,221146
495,35,2004,3967,3616,585,581,233065,82144,2.837273568,3382,9118,88496,7.177725547,6352,233646
496,35,2005,4159,4987,589,703,243739,86168,2.828648686,3570,7226,93034,7.380097599,6866,244442
497,35,2006,4112,5378,654,720,257113,91172,2.820087308,3458,9933,98058,7.022374513,6886,257833
498,35,2007,4205,3786,748,728,267871,95275,2.811556022,3457,7309,101912,6.512481356,6637,268599
499,35,2008,3938,2168,784,967,275773,98378,2.803197869,3154,4987,104350,5.723047437,5972,276740
500,35,2009,3773,1344,779,1042,281121,100581,2.794971217,2994,2429,106155,5.250812491,5574,282163
501,37,1985,386,74,41,6,18023,7498,2.403708,345,923,13585,44.8,6087,18029
502,37,1986,361,203,56,7,18846,7820,2.409974,305,519,13921,43.8,6101,18853
503,37,1987,370,205,61,7,18995,8050,2.359627,309,-160,14093,42.9,6043,19002
504,37,1988,370,392,53,7,19560,8396,2.329681,317,248,14317,41.4,5921,19567
505,37,1989,415,509,40,7,20874,8971,2.326831,375,939,14688,38.9,5717,20881
506,37,1990,421,619,43,116,22002,8354,2.633708,378,859,15226,45.1,6872,22118
507,37,1991,411,466,44,118,23340,8763,2.663471,367,973,15845,44.7,7082,23458
508,37,1992,431,556,44,125,24815,9157,2.709949,387,1095,16524,44.6,7367,24940
509,37,1993,432,910,62,128,26704,9764,2.734945,370,1522,17077,42.8,7313,26832
510,37,1994,469,1067,67,145,28882,10754,2.685698,402,1793,17987,40.2,7233,29027
511,37,1995,436,1019,62,145,30738,11291,2.722345,374,1482,19054,40.7,7763,30883
512,37,1996,492,972,75,150,32778,11906,2.753066,417,1628,20073,40.7,8167,32928
513,37,1997,599,1477,62,156,35050,12652,2.770313,537,1741,21044,39.9,8392,35206
514,37,1998,630,1125,60,156,37458,13334,2.80921,570,1838,22521,40.8,9187,37614
515,37,1999,645,864,49,156,39753,13590,2.925166,596,1699,23646,42.5,10056,39909
516,37,2000,774,165,80,353,42936,15751,2.725922164,694,2685,25145,37.35931597,9394,43289
517,37,2001,785,661,64,353,44087,16146,2.730521491,721,430,25966,37.81868597,9820,44440
518,37,2002,769,533,87,353,44747,16378,2.732140677,682,-22,26510,38.2195398,10132,45100
519,37,2003,830,659,88,353,45405,16600,2.735240964,742,-84,27274,39.13617365,10674,45758
520,37,2004,794,489,90,353,46132,16849,2.737966645,704,23,27864,39.53129486,11015,46485
521,37,2005,769,727,89,353,46925,17124,2.740306003,680,113,28711,40.35735432,11587,47278
522,37,2006,851,745,98,353,47861,17448,2.743065108,753,183,29573,41.0002367,12125,48214
523,37,2007,872,578,84,353,48931,17818,2.746155573,788,282,30271,41.13838327,12453,49284
524,37,2008,858,520,104,353,49948,18181,2.747263627,754,263,30917,41.19416502,12736,50301
525,37,2009,871,164,93,366,51154,18612,2.748441865,778,441,31165,40.27915931,12553,51520
526,39,1985,109,184,42,35,8525,2908,2.931568,67,233,3520,17.4,612,8560
527,39,1986,129,225,49,35,8758,3007,2.912537,80,153,3712,19,705,8793
528,39,1987,147,160,40,37,9303,3199,2.908096,107,440,3945,18.9,746,9340
529,39,1988,125,137,43,37,9792,3370,2.905638,82,407,4110,18,740,9829
530,39,1989,122,100,56,36,9689,3349,2.893102,66,-170,4243,21.1,894,9725
531,39,1990,156,97,51,45,9718,3377,2.877702,105,-67,3997,15.5,620,9763
532,39,1991,141,102,53,46,10222,3637,2.810558,88,417,4094,11.2,457,10268
533,39,1992,152,194,51,47,10719,3662,2.927089,101,397,4196,12.7,534,10766
534,39,1993,111,368,53,52,11490,4084,2.813418,58,718,4390,7,306,11542
535,39,1994,155,558,66,61,12786,4537,2.818162,89,1216,4758,4.6,221,12847
536,39,1995,179,494,53,54,14274,5081,2.809289,126,1355,5316,4.4,235,14328
537,39,1996,182,418,60,52,15754,5652,2.787332,122,1356,5835,3.1,183,15806
538,39,1997,192,316,75,56,16931,6139,2.757941,117,1064,6253,1.8,114,16987
539,39,1998,217,311,69,56,17976,6538,2.749465,148,897,6569,0.5,31,18032
540,39,1999,216,291,63,56,19031,6866,2.771774,153,902,6880,0.2,14,19087
541,39,2000,208,77,91,35,20069,6859,2.925936725,117,901,7186,4.55051489,327,20104
542,39,2001,256,308,83,35,21259,7311,2.907810149,173,1017,7486,2.337697034,175,21294
543,39,2002,236,297,91,35,21569,7464,2.889737406,145,165,7772,3.962943901,308,21604
544,39,2003,214,191,89,37,21896,7624,2.871983211,125,204,7948,4.076497232,324,21933
545,39,2004,215,162,111,47,21994,7709,2.853028927,104,4,8099,4.81540931,390,22041
546,39,2005,202,213,89,53,22206,7832,2.835291113,113,105,8297,5.604435338,465,22259
547,39,2006,196,248,86,53,22474,7979,2.81664369,110,158,8535,6.514352665,556,22527
548,39,2007,204,232,94,53,22425,8015,2.797878977,110,-159,8756,8.462768387,741,22478
549,39,2008,164,142,124,53,22610,8135,2.779348494,40,145,8887,8.461798132,752,22663
550,39,2009,185,55,117,53,22837,8273,2.76042548,68,159,8916,7.21175415,643,22890
551,41,1985,7055,6499,1851,17384,351122,133562,2.628906,5204,8645,149466,10.6,15904,368506
552,41,1986,7592,6364,2010,17872,361432,138529,2.609071,5582,5216,156153,11.3,17624,379304
553,41,1987,7642,2661,2118,18554,374166,144240,2.594052,5524,7892,162616,11.3,18376,392720
554,41,1988,7657,1525,2068,20592,374673,145431,2.576294,5589,-3044,165354,12,19923,395265
555,41,1989,7613,854,2172,19366,376948,147299,2.559067,5441,-4392,166667,11.6,19368,396314
556,41,1990,7343,1025,2134,15554,382333,146965,2.601524,5209,-3636,165056,11,18091,397887
557,41,1991,7289,1187,2260,15447,390507,147907,2.64022,5029,3038,166081,10.9,18174,405954
558,41,1992,7498,2789,2204,16052,406763,154318,2.635875,5294,11567,167268,7.7,12950,422815
559,41,1993,7479,3682,2324,16644,420491,160771,2.615465,5155,9165,170159,5.5,9388,437135
560,41,1994,7444,3764,2326,17237,439263,166447,2.639056,5118,14247,173741,4.2,7294,456500
561,41,1995,7763,4723,2432,17822,451871,170856,2.644748,5331,7862,177505,3.7,6649,469693
562,41,1996,7611,5291,2558,17627,459362,174384,2.634198,5053,2243,182530,4.5,8146,476989
563,41,1997,7744,4792,2694,19211,467594,178758,2.615793,5050,4766,187987,4.9,9229,486805
564,41,1998,7738,4953,2729,19539,478482,182589,2.620541,5009,6207,193073,5.4,10484,498021
565,41,1999,8041,5536,2819,19867,488948,186150,2.626634,5222,5572,198250,6.1,12100,508815
566,41,2000,8276,1522,2914,15396,504406,193554,2.606022092,5362,5631,204091,5.162893023,10537,519802
567,41,2001,8338,6087,2999,15502,520834,200185,2.601763369,5339,11195,211168,5.201072132,10983,536336
568,41,2002,8703,6923,3125,15428,529812,204070,2.596226785,5578,3326,217845,6.323303266,13775,545240
569,41,2003,8420,6627,3215,15429,536239,206723,2.593997765,5205,1223,226996,8.930994379,20273,551668
570,41,2004,8234,5103,3378,15526,542929,209755,2.588395986,4856,1931,233118,10.02196313,23363,558455
571,41,2005,8543,6318,3252,15560,553762,214275,2.584351884,5291,5576,239367,10.48264798,25092,569322
572,41,2006,8624,6529,3430,16080,566422,219699,2.578172864,5194,7986,244173,10.02322124,24474,582502
573,41,2007,8921,4197,3354,16022,572750,222624,2.572723516,5567,703,247960,10.21777706,25336,588772
574,41,2008,9043,2926,3464,16080,582980,227125,2.566780407,5579,4709,250335,9.271576088,23210,599060
575,41,2009,8587,1905,3513,16255,592263,231329,2.560262656,5074,4384,251891,8.163054655,20562,608518
576,43,1985,364,259,374,2749,28617,10955,2.612232,-10,93,13085,16.3,2130,31366
577,43,1986,401,261,344,2687,28443,10868,2.617133,57,-293,13450,19.2,2582,31130
578,43,1987,364,110,358,2697,28697,10955,2.619534,6,258,13761,20.4,2806,31394
579,43,1988,350,78,415,3583,28310,10830,2.614035,-65,564,13897,22.1,3067,31893
580,43,1989,366,122,399,4037,28077,10732,2.616194,-33,254,14600,26.5,3868,32114
581,43,1990,312,127,429,3903,28297,11713,2.415863,-117,203,13683,14.4,1970,32200
582,43,1991,336,81,402,3734,28503,11609,2.45525,-66,103,13837,16.1,2228,32237
583,43,1992,357,169,407,3911,29907,11768,2.541384,-50,1631,13923,15.5,2155,33818
584,43,1993,391,209,420,5854,30653,12579,2.436839,-29,2718,14105,10.8,1526,36507
585,43,1994,384,277,396,6831,31874,12565,2.536729,-12,2210,14336,12.4,1771,38705
586,43,1995,418,336,479,8080,32442,12776,2.539292,-61,1878,14635,12.7,1859,40522
587,43,1996,448,241,514,11970,29858,11726,2.546307,-66,1372,14971,21.7,3245,41828
588,43,1997,444,327,448,8295,34549,13489,2.561272,-4,1020,15212,11.3,1723,42844
589,43,1998,406,356,470,8745,35068,13666,2.566076,-64,1033,15539,12.1,1873,43813
590,43,1999,445,416,476,9195,35949,13930,2.580689,-31,1362,15895,12.4,1965,45144
591,43,2000,473,94,462,9143,37227,15344,2.426160063,11,1224,17230,10.94602438,1886,46370
592,43,2001,446,374,479,9061,37672,15616,2.412397541,-33,396,17347,9.978670664,1731,46733
593,43,2002,404,360,464,9109,37860,15781,2.39908751,-60,296,17559,10.12586138,1778,46969
594,43,2003,420,239,516,9164,37664,15783,2.386365076,-96,-45,17692,10.79018766,1909,46828
595,43,2004,401,296,494,9280,37260,15701,2.373097255,-93,-195,17975,12.65090403,2274,46540
596,43,2005,402,215,493,9243,37204,15764,2.360060898,-91,-2,18191,13.34176241,2427,46447
597,43,2006,439,262,483,9219,37484,15969,2.34729789,-44,300,18444,13.41899805,2475,46703
598,43,2007,422,235,516,9197,37457,16045,2.334496728,-94,45,18685,14.12898047,2640,46654
599,43,2008,425,154,458,9347,37427,16124,2.321198214,-33,153,18925,14.8005284,2801,46774
600,43,2009,413,91,491,9305,37330,16169,2.308738945,-78,-61,19104,15.36327471,2935,46635
601,45,1985,467,56,172,444,25270,9426,2.680883,295,-238,12647,25.5,3221,25714
602,45,1986,441,22,173,448,25743,9638,2.67099,268,209,12265,21.4,2627,26191
603,45,1987,424,68,193,451,25936,9728,2.666118,231,-35,12078,19.5,2350,26387
604,45,1988,418,111,178,645,26680,9944,2.683025,240,698,12166,18.3,2222,27325
605,45,1989,445,182,206,725,28084,10490,2.677216,239,1245,12290,14.6,1800,28809
606,45,1990,493,216,192,691,29460,11266,2.614948,301,1041,12517,10,1251,30151
607,45,1991,495,132,210,721,30509,11812,2.582882,285,794,12733,7.2,921,31230
608,45,1992,462,327,188,714,30625,11868,2.580468,274,-165,12880,7.9,1012,31339
609,45,1993,426,376,204,749,31825,12142,2.621067,222,1013,13220,8.2,1078,32574
610,45,1994,465,533,212,768,33728,12737,2.648033,253,1669,13648,6.7,911,34496
611,45,1995,498,406,229,807,35610,13407,2.656075,269,1652,14181,5.5,774,36417
612,45,1996,561,384,230,837,36840,13876,2.654944,331,929,14695,5.6,819,37677
613,45,1997,603,403,250,876,38018,14332,2.652665,353,864,15131,5.3,799,38894
614,45,1998,580,497,237,961,40270,14936,2.69617,343,1994,15534,3.8,598,41231
615,45,1999,676,635,256,1046,41645,15455,2.694597,420,1040,16097,4,642,42691
616,45,2000,733,164,242,849,43391,16387,2.647891621,491,1055,17521,6.47223332,1134,44240
617,45,2001,796,655,269,850,45057,16962,2.656349487,527,1140,18229,6.950463547,1267,45907
618,45,2002,811,546,282,848,45880,17228,2.663106571,529,292,18927,8.976594283,1699,46728
619,45,2003,866,508,288,849,46635,17459,2.671115184,578,178,19525,10.58130602,2066,47484
620,45,2004,811,356,275,843,47313,17660,2.679105323,536,136,20008,11.73530588,2348,48156
621,45,2005,832,485,271,848,48408,18011,2.687690856,561,539,20598,12.55947179,2587,49256
622,45,2006,893,569,274,852,50254,18643,2.695596202,619,1231,21230,12.18558643,2587,51106
623,45,2007,971,718,290,847,51829,19162,2.704780294,681,889,22106,13.31765132,2944,52676
624,45,2008,975,574,286,830,53396,19680,2.713211382,689,861,22805,13.70313528,3125,54226
625,45,2009,997,385,268,851,54549,20048,2.720919792,729,445,23145,13.3808598,3097,55400
626,47,1985,41,36,17,51,3030,1128,2.68617,24,31,2185,48.4,1057,3081
627,47,1986,41,24,12,53,3184,1170,2.721368,29,127,2219,47.3,1049,3237
628,47,1987,58,16,10,53,3226,1162,2.776248,48,-6,2240,48.1,1078,3279
629,47,1988,41,16,13,51,3121,1110,2.811712,28,-135,2256,50.8,1146,3172
630,47,1989,41,20,10,50,3064,1078,2.842301,31,-89,2265,52.4,1187,3114
631,47,1990,34,16,11,2,3067,1308,2.344801,23,-68,2438,46.3,1130,3069
632,47,1991,31,17,15,2,3087,1327,2.3263,16,4,2454,45.9,1127,3089
633,47,1992,32,34,22,2,3242,1382,2.345876,10,145,2471,44.1,1089,3244
634,47,1993,40,32,13,2,3374,1438,2.346314,27,105,2505,42.6,1067,3376
635,47,1994,37,58,14,2,3497,1487,2.351715,23,100,2537,41.4,1050,3499
636,47,1995,45,67,16,2,3666,1561,2.348495,29,140,2595,39.8,1034,3668
637,47,1996,48,254,13,2,3790,1618,2.342398,35,89,2662,39.2,1044,3792
638,47,1997,41,80,14,3,4032,1750,2.304,27,216,2916,40,1166,4035
639,47,1998,48,86,13,3,4243,1841,2.304726,35,176,2996,38.6,1155,4246
640,47,1999,46,81,16,3,4535,1937,2.341249,30,262,3082,37.2,1145,4538
641,47,2000,72,20,17,24,4779,2066,2.313165537,55,210,2950,29.96610169,884,4803
642,47,2001,57,81,15,24,4805,2088,2.301245211,42,-16,3035,31.20263591,947,4829
643,47,2002,66,63,26,24,4806,2099,2.289661744,40,-39,3102,32.33397808,1003,4830
644,47,2003,53,69,31,24,4827,2118,2.279036827,22,-1,3175,33.29133858,1057,4851
645,47,2004,56,54,26,46,4779,2107,2.268153773,30,-56,3234,34.84848485,1127,4825
646,47,2005,55,73,20,52,4840,2145,2.256410256,35,32,3312,35.23550725,1167,4892
647,47,2006,73,83,28,45,4908,2190,2.24109589,45,16,3401,35.60717436,1211,4953
648,47,2007,58,72,19,37,4927,2211,2.228403437,39,-28,3479,36.44725496,1268,4964
649,47,2008,49,39,30,37,5047,2279,2.214567793,19,101,3524,35.3291714,1245,5084
650,47,2009,52,44,26,37,5359,2435,2.200821355,26,286,3545,31.31170663,1110,5396
651,49,1985,144,160,41,9,9203,3751,2.453479,103,218,9948,62.3,6197,9212
652,49,1986,157,96,30,9,9130,3785,2.412153,127,-200,10113,62.6,6328,9139
653,49,1987,122,77,37,9,8899,3749,2.3737,85,-316,10213,63.3,6464,8908
654,49,1988,104,44,29,9,8458,3620,2.336464,75,-516,10301,64.9,6681,8467
655,49,1989,110,38,40,9,8169,3556,2.297244,70,-359,10305,65.5,6749,8178
656,49,1990,120,63,32,75,7931,3168,2.503472,88,-260,9985,68.3,6817,8006
657,49,1991,100,61,35,73,8316,3129,2.657718,65,318,10048,68.9,6919,8389
658,49,1992,90,89,33,72,8532,3046,2.801051,57,158,10109,69.9,7063,8604
659,49,1993,86,129,40,80,8845,3376,2.619964,46,275,10198,66.9,6822,8925
660,49,1994,91,273,40,82,9257,3465,2.671573,51,363,10327,66.4,6862,9339
661,49,1995,117,247,33,87,9866,3645,2.706722,84,530,10600,65.6,6955,9953
662,49,1996,111,282,44,90,10421,3808,2.736607,67,491,10847,64.9,7039,10511
663,49,1997,124,364,42,92,10874,3949,2.753608,82,373,11129,64.5,7180,10966
664,49,1998,134,644,42,92,11317,4055,2.790875,92,351,11493,64.7,7438,11409
665,49,1999,136,485,55,92,11903,4208,2.82866,81,505,12137,65.3,7929,11995
666,49,2000,150,132,59,393,12460,5255,2.371075167,91,766,12198,56.91916708,6943,12853
667,49,2001,153,529,62,393,12890,5464,2.359077599,91,339,12716,57.03051274,7252,13283
668,49,2002,159,466,67,393,13068,5562,2.349514563,92,86,13169,57.76444681,7607,13461
669,49,2003,163,348,54,393,13295,5682,2.339845125,109,118,13267,57.17193035,7585,13688
670,49,2004,142,432,40,393,13519,5798,2.331666092,102,122,13662,57.56111843,7864,13912
671,49,2005,146,513,73,393,13504,5813,2.323068983,73,-88,14074,58.69688788,8261,13897
672,49,2006,139,606,59,393,13742,5939,2.313857552,80,158,14541,59.15686679,8602,14135
673,49,2007,170,792,49,393,13946,6053,2.303981497,121,83,15327,60.50760097,9274,14339
674,49,2008,156,574,57,393,14142,6163,2.294661691,99,97,15786,60.95907766,9623,14535
675,49,2009,145,313,54,393,14271,6248,2.284090909,91,38,15980,60.90112641,9732,14664
676,51,1985,140,87,50,1399,8991,4072,2.208006,90,-117,7165,43.2,3093,10390
677,51,1986,149,117,51,1472,9418,4368,2.156136,98,402,7243,39.7,2875,10890
678,51,1987,126,119,58,1485,9370,4448,2.106565,68,-103,7350,39.5,2902,10855
679,51,1988,129,126,52,1032,9795,4525,2.164641,77,-105,7477,39.5,2952,10827
680,51,1989,126,123,36,989,9520,4507,2.11227,90,-408,7544,40.3,3037,10509
681,51,1990,127,163,47,1087,9194,3855,2.384955,80,-308,7294,47.1,3439,10281
682,51,1991,124,166,47,1078,9338,3984,2.343875,77,58,7457,46.6,3473,10416
683,51,1992,122,233,50,1139,9637,4274,2.254797,72,288,7623,43.9,3349,10776
684,51,1993,138,257,57,1327,9984,4325,2.308439,81,454,7856,44.9,3531,11311
685,51,1994,124,339,43,1235,10436,4565,2.28609,81,279,8113,43.7,3548,11671
686,51,1995,91,325,59,1182,10792,4721,2.285956,32,271,8452,44.1,3731,11974
687,51,1996,129,235,49,1110,11134,4872,2.285304,80,190,8777,44.5,3905,12244
688,51,1997,118,276,61,1074,11331,4992,2.269832,57,104,9012,44.6,4020,12405
689,51,1998,134,260,33,1079,12363,5083,2.432225,101,936,9288,45.3,4205,13442
690,51,1999,130,309,48,1084,12652,5472,2.312135,82,212,9660,43.4,4188,13736
691,51,2000,155,80,53,975,13014,5667,2.29645315,102,151,9222,38.54912167,3555,13989
692,51,2001,186,321,66,1039,13306,5810,2.290189329,120,236,9571,39.29578936,3761,14345
693,51,2002,171,194,71,1113,13203,5786,2.281887314,100,-129,9793,40.91698152,4007,14316
694,51,2003,178,194,73,1066,13140,5775,2.275324675,105,-215,10020,42.36526946,4245,14206
695,51,2004,165,191,70,897,13333,5884,2.265975527,95,-71,10244,42.56149941,4360,14230
696,51,2005,168,192,73,839,13634,6035,2.25915493,95,148,10456,42.28194338,4421,14473
697,51,2006,158,262,51,841,13809,6134,2.251222693,107,70,10738,42.8757683,4604,14650
698,51,2007,162,243,49,830,14127,6298,2.243093045,113,194,11002,42.75586257,4704,14957
699,51,2008,168,173,66,808,14329,6412,2.234716157,102,78,11214,42.82147316,4802,15137
700,51,2009,182,87,59,808,14458,6493,2.227048675,123,6,11338,42.7412242,4846,15266
701,53,1985,5,20,0,0,472,168,2.809524,5,-116,888,81.1,720,472
702,53,1986,6,4,3,0,468,165,2.836364,3,-7,908,81.8,743,468
703,53,1987,8,15,0,0,508,176,2.886364,6,32,913,80.7,737,508
704,53,1988,3,19,4,0,489,166,2.945783,-1,-18,929,82.1,763,489
705,53,1989,5,10,4,0,476,160,2.975,1,-14,987,83.8,827,476
706,53,1990,3,13,3,0,463,214,2.163551,0,-13,1254,82.9,1040,463
707,53,1991,3,7,0,0,453,199,2.276382,3,-13,1267,84.3,1068,453
708,53,1992,4,12,0,0,504,210,2.4,4,47,1274,83.5,1064,504
709,53,1993,9,19,0,0,546,245,2.228571,9,33,1286,80.9,1041,546
710,53,1994,5,32,0,0,612,274,2.233577,5,61,1305,79,1031,612
711,53,1995,3,17,4,0,659,294,2.241497,-1,48,1337,78,1043,659
712,53,1996,7,29,3,0,707,314,2.251592,4,44,1354,76.8,1040,707
713,53,1997,4,20,4,0,739,330,2.239394,0,32,1383,76.1,1053,739
714,53,1998,6,13,0,0,776,345,2.249275,6,31,1403,75.4,1058,776
715,53,1999,8,13,4,0,784,345,2.272464,4,4,1416,75.6,1071,784
716,53,2000,12,4,0,0,792,360,2.2,12,-7,1307,72.45600612,947,792
717,53,2001,6,15,4,0,804,366,2.196721311,2,10,1316,72.18844985,950,804
718,53,2002,10,16,5,0,806,367,2.196185286,5,-3,1325,72.30188679,958,806
719,53,2003,5,14,1,0,784,358,2.189944134,4,-26,1333,73.14328582,975,784
720,53,2004,8,8,1,0,831,380,2.186842105,7,40,1335,71.53558052,955,831
721,53,2005,8,15,2,0,813,372,2.185483871,6,-24,1343,72.30081906,971,813
722,53,2006,7,17,5,0,830,380,2.184210526,2,15,1356,71.97640118,976,830
723,53,2007,9,12,1,0,845,388,2.177835052,8,7,1363,71.53338225,975,845
724,53,2008,8,27,2,0,824,378,2.17989418,6,-27,1383,72.6681128,1005,824
725,53,2009,10,17,2,0,827,380,2.176315789,8,-5,1386,72.58297258,1006,827
726,55,1985,85,38,81,144,6665,2778,2.399208,4,165,4123,32.6,1345,6809
727,55,1986,83,31,80,144,6608,2811,2.350765,3,-60,4179,32.7,1368,6752
728,55,1987,71,70,69,142,6358,2757,2.30613,2,-254,4227,34.8,1470,6500
729,55,1988,78,18,68,138,6154,2722,2.260838,10,-218,4302,36.7,1580,6292
730,55,1989,59,17,86,137,5993,2704,2.216346,-27,-135,4334,37.6,1630,6130
731,55,1990,61,11,71,116,5888,2446,2.407195,-10,-116,3913,37.5,1467,6004
732,55,1991,59,14,81,108,5949,2307,2.578674,-22,75,3929,41.3,1622,6057
733,55,1992,59,23,67,109,6072,2306,2.633131,-8,132,3943,41.5,1637,6181
734,55,1993,69,26,88,123,6316,2597,2.432037,-19,277,3966,34.5,1369,6439
735,55,1994,67,60,70,132,6791,2777,2.445445,-3,487,3992,30.4,1215,6923
736,55,1995,62,71,88,136,7026,2865,2.452356,-26,265,4052,29.3,1187,7162
737,55,1996,50,96,89,140,7249,2951,2.456455,-39,266,4123,28.4,1172,7389
738,55,1997,65,107,84,145,7527,3077,2.446214,-19,302,4219,27.1,1142,7672
739,55,1998,64,109,102,892,6889,2823,2.440312,-38,147,4326,34.7,1503,7781
740,55,1999,70,115,97,1639,6188,2535,2.441026,-27,73,4435,42.8,1900,7827
741,55,2000,71,23,92,919,6908,3072,2.248697917,-21,18,4620,33.50649351,1548,7827
742,55,2001,74,93,89,1061,6844,3065,2.232952692,-15,93,4705,34.8565356,1640,7905
743,55,2002,83,90,98,1035,6881,3104,2.21681701,-15,26,4787,35.15771882,1683,7916
744,55,2003,79,60,112,1165,6877,3126,2.19993602,-33,159,4837,35.37316519,1711,8042
745,55,2004,73,50,88,1086,6643,3043,2.18304305,-15,-298,4878,37.61787618,1835,7729
746,55,2005,61,51,95,1167,6656,3073,2.165961601,-34,128,4918,37.5152501,1845,7823
747,55,2006,58,38,92,1173,6577,3059,2.150049036,-34,-39,4946,38.15204205,1887,7750
748,55,2007,58,47,92,1167,6491,3043,2.133092343,-34,-58,4984,38.94462279,1941,7658
749,55,2008,59,62,119,1183,6497,3071,2.115597525,-60,82,5035,39.00695134,1964,7680
750,55,2009,56,32,108,418,6292,2998,2.098732488,-52,-918,5056,40.70411392,2058,6710
751,57,1985,28,7,7,19,1710,600,2.85,21,-85,1166,48.5,566,1729
752,57,1986,19,8,7,18,1690,592,2.85473,12,-33,1170,49.4,578,1708
753,57,1987,20,12,12,19,1756,612,2.869281,8,59,1175,47.9,563,1775
754,57,1988,17,5,16,18,1695,588,2.882653,1,-63,1189,50.5,601,1713
755,57,1989,21,6,9,17,1634,566,2.886926,12,-74,1232,54.1,666,1651
756,57,1990,23,11,14,11,1586,632,2.509494,9,-63,1326,52.3,694,1597
757,57,1991,16,2,7,10,1546,619,2.497577,9,-50,1337,53.7,718,1556
758,57,1992,22,3,11,10,1564,603,2.593698,11,7,1339,55,736,1574
759,57,1993,21,6,16,12,1620,673,2.407132,5,53,1342,49.9,669,1632
760,57,1994,22,13,16,12,1630,682,2.390029,6,4,1348,49.4,666,1642
761,57,1995,13,17,10,12,1597,679,2.351988,3,-36,1361,50.1,682,1609
762,57,1996,12,25,11,12,1582,685,2.309489,1,-16,1378,50.3,693,1594
763,57,1997,16,14,11,12,1584,701,2.259629,5,-3,1403,50,702,1596
764,57,1998,16,17,16,12,1575,708,2.224576,0,-9,1417,50,709,1587
765,57,1999,18,16,11,12,1570,717,2.189679,7,-12,1434,50,717,1582
766,57,2000,12,6,7,10,1566,662,2.365558912,5,-9,1151,42.48479583,489,1576
767,57,2001,17,23,18,10,1580,675,2.340740741,-1,15,1176,42.60204082,501,1590
768,57,2002,18,16,10,10,1581,680,2.325,8,-7,1193,43.00083822,513,1591
769,57,2003,12,9,12,10,1576,685,2.300729927,0,-5,1204,43.10631229,519,1586
770,57,2004,10,14,8,10,1511,664,2.27560241,2,-67,1219,45.52912223,555,1521
771,57,2005,9,10,12,10,1482,657,2.255707763,-3,-26,1231,46.62875711,574,1492
772,57,2006,15,13,12,10,1433,642,2.232087227,3,-52,1246,48.47512039,604,1443
773,57,2007,12,12,11,10,1412,638,2.213166144,1,-22,1260,49.36507937,622,1422
774,57,2008,11,8,13,10,1371,627,2.186602871,-2,-39,1270,50.62992126,643,1381
775,57,2009,8,12,14,10,1376,636,2.163522013,-6,11,1280,50.3125,644,1386
776,59,1985,6675,4909,2182,6206,415411,148723,2.793186,4493,3441,163850,9.2,15127,421617
777,59,1986,6811,4801,2149,6216,420854,151297,2.781641,4662,791,168344,10.1,17047,427070
778,59,1987,6551,2809,2161,6213,423974,152699,2.776534,4390,-1273,173123,11.8,20424,430187
779,59,1988,6587,1525,2419,6201,426228,153871,2.770035,4168,-1926,175952,12.5,22081,432429
780,59,1989,6527,1742,2219,5856,430049,155728,2.761539,4308,-832,177967,12.5,22239,435905
781,59,1990,6711,1734,2419,6482,433403,166545,2.602318,4292,-312,178611,6.8,12066,439885
782,59,1991,6445,2201,2430,6523,443140,170280,2.60242,4015,5763,180338,5.6,10058,449663
783,59,1992,6538,3350,2418,6875,456665,175300,2.605048,4120,9757,182919,4.2,7619,463540
784,59,1993,6513,3761,2597,7055,469153,180710,2.596165,3916,8752,186285,3,5575,476208
785,59,1994,6472,4093,2670,6844,476589,182527,2.61106,3802,3423,189667,3.8,7140,483433
786,59,1995,6352,5102,2712,6904,484410,185470,2.611797,3640,4241,193161,4,7691,491314
787,59,1996,6229,3576,2796,7073,490973,188494,2.604714,3433,3299,197664,4.6,9170,498046
788,59,1997,6372,3686,2965,7151,497083,192227,2.585917,3407,2781,201048,4.4,8821,504234
789,59,1998,6358,3675,3076,7119,505364,194447,2.598981,3282,4967,204371,4.9,9924,512483
790,59,1999,6301,2924,3030,7087,513723,198498,2.588051,3271,5056,208057,4.6,9559,520810
791,59,2000,6701,847,3159,7730,518988,206160,2.517403958,3542,2365,212761,3.102542289,6601,526718
792,59,2001,6532,3387,3133,7788,520279,207436,2.50814227,3399,-2050,216341,4.116186946,8905,528067
793,59,2002,6551,2673,3400,7730,519809,208047,2.498517162,3151,-3679,218986,4.995296503,10939,527539
794,59,2003,6620,2229,3444,7760,517669,208064,2.488027722,3176,-5286,221186,5.932563544,13122,525429
795,59,2004,6337,1642,3367,7827,517049,208717,2.477273054,2970,-3523,222899,6.362522936,14182,524876
796,59,2005,6183,2535,3338,7797,515720,209058,2.466875221,2845,-4204,224639,6.936017343,15581,523517
797,59,2006,6138,2151,3462,7767,516812,210389,2.456459226,2676,-1614,226430,7.084308616,16041,524579
798,59,2007,6194,2059,3541,7840,519280,212308,2.445892034,2653,-112,227770,6.788865961,15463,527120
799,59,2008,6167,1073,3736,7796,522769,214695,2.434937935,2431,1014,229029,6.258596073,14334,530565
800,59,2009,5934,602,3678,7795,524811,216523,2.423811789,2256,-215,229781,5.769841719,13258,532606
801,61,1985,24,0,12,29,1818,728,2.497253,12,-123,855,14.9,127,1847
802,61,1986,22,-1,15,29,1769,717,2.467225,7,-56,844,15,127,1798
803,61,1987,25,0,16,28,1730,709,2.440056,9,-49,833,14.9,124,1758
804,61,1988,22,-1,10,28,1683,697,2.414634,12,-59,834,16.4,137,1711
805,61,1989,20,-1,21,28,1670,699,2.389127,-1,-12,904,22.7,205,1698
806,61,1990,16,0,16,44,1644,657,2.502283,0,-10,878,25.2,221,1688
807,61,1991,19,0,21,47,1636,704,2.323864,-2,-3,878,19.8,174,1683
808,61,1992,15,4,19,48,1647,710,2.319718,-4,16,878,19.1,168,1695
809,61,1993,14,0,19,46,1652,677,2.440177,-5,8,882,23.2,205,1698
810,61,1994,16,1,24,46,1647,677,2.432792,-8,3,882,23.2,205,1693
811,61,1995,20,3,10,46,1597,663,2.408748,10,-60,883,24.9,220,1643
812,61,1996,14,1,19,47,1615,679,2.378498,-5,24,886,23.4,207,1662
813,61,1997,17,0,25,47,1614,689,2.342525,-8,7,887,22.3,198,1661
814,61,1998,19,1,18,47,1597,689,2.317852,1,-18,887,22.3,198,1644
815,61,1999,14,1,13,47,1585,690,2.297101,1,-13,888,22.3,198,1632
816,61,2000,16,0,14,24,1590,663,2.398190045,2,-14,816,18.75,153,1614
817,61,2001,16,0,25,24,1582,663,2.38612368,-9,1,813,18.4501845,150,1606
818,61,2002,14,1,16,24,1542,651,2.368663594,-2,-38,811,19.72872996,160,1566
819,61,2003,23,0,18,24,1524,649,2.348228043,5,-23,809,19.77750309,160,1548
820,61,2004,11,0,22,24,1499,643,2.33125972,-11,-14,806,20.22332506,163,1523
821,61,2005,16,2,20,28,1515,655,2.312977099,-4,24,805,18.63354037,150,1543
822,61,2006,7,1,18,11,1503,655,2.294656489,-11,-18,803,18.43088418,148,1514
823,61,2007,22,2,24,18,1453,637,2.28100471,-2,-41,802,20.57356608,165,1471
824,61,2008,15,1,22,18,1414,626,2.258785942,-7,-32,801,21.84769039,175,1432
825,61,2009,17,3,19,18,1374,611,2.248772504,-2,-38,803,23.91033624,192,1392
826,63,1985,119,2,69,70,7477,2930,2.551877,50,-304,3560,17.7,630,7547
827,63,1986,108,2,75,69,7304,2903,2.516018,33,-207,3552,18.3,649,7373
828,63,1987,118,4,51,68,7173,2890,2.482007,67,-199,3545,18.5,655,7241
829,63,1988,119,4,70,69,7211,2941,2.451887,49,-10,3554,17.2,613,7280
830,63,1989,112,1,74,69,7132,2950,2.417627,38,-117,3580,17.6,630,7201
831,63,1990,110,3,61,66,7062,2785,2.535727,49,-122,3224,13.6,439,7128
832,63,1991,120,3,57,64,7097,2733,2.59678,63,-30,3227,15.3,494,7161
833,63,1992,96,6,64,65,7167,2750,2.606182,32,39,3230,14.9,480,7232
834,63,1993,107,-1,54,66,7201,2812,2.560811,53,-18,3236,13.1,424,7267
835,63,1994,96,20,80,67,7273,2821,2.578164,16,57,3235,12.8,414,7340
836,63,1995,75,20,68,68,7345,2846,2.580815,7,66,3255,12.6,409,7413
837,63,1996,83,18,73,69,7417,2875,2.579826,10,63,3275,12.2,400,7486
838,63,1997,67,15,66,70,7529,2935,2.565247,1,112,3293,10.9,358,7599
839,63,1998,75,32,77,70,7684,2984,2.575067,-2,157,3308,9.8,324,7754
840,63,1999,101,57,71,70,7831,3034,2.581081,30,117,3340,9.2,306,7901
841,63,2000,100,8,85,531,7444,2979,2.498825109,15,59,3437,13.32557463,458,7975
842,63,2001,107,31,69,598,7475,3007,2.485866312,38,60,3469,13.31795907,462,8073
843,63,2002,80,14,85,765,7524,3046,2.470935961,-5,221,3482,12.55025847,437,8289
844,63,2003,78,17,67,788,7397,3009,2.457475083,11,-115,3497,13.92622248,487,8185
845,63,2004,90,5,72,964,7293,2985,2.44321608,18,54,3503,14.78732515,518,8257
846,63,2005,108,6,68,1000,6998,2881,2.429017702,40,-299,3509,17.89683671,628,7998
847,63,2006,98,11,92,1035,6911,2861,2.415588955,6,-58,3519,18.69849389,658,7946
848,63,2007,92,2,80,1024,6811,2836,2.401622003,12,-123,3520,19.43181818,684,7835
849,63,2008,101,6,67,1334,6708,2807,2.389739936,34,173,3525,20.36879433,718,8042
850,63,2009,102,1,76,1508,6761,2846,2.375614898,26,201,3526,19.28530913,680,8269
851,65,1985,109,8,33,96,6693,2452,2.729609,76,-455,3833,36,1381,6789
852,65,1986,94,7,35,92,6358,2362,2.691787,59,-398,3811,38,1449,6450
853,65,1987,89,10,32,87,5958,2239,2.661009,57,-462,3788,40.9,1549,6045
854,65,1988,82,9,33,83,5667,2153,2.632141,49,-344,3803,43.4,1650,5750
855,65,1989,93,3,31,85,5811,2236,2.598837,62,84,3768,40.7,1532,5896
856,65,1990,90,3,36,24,6011,2382,2.52351,54,85,3527,32.5,1145,6035
857,65,1991,103,8,32,20,6121,2430,2.51893,71,35,3530,31.2,1100,6141
858,65,1992,116,16,31,18,6191,2501,2.47541,85,-17,3538,29.3,1037,6209
859,65,1993,103,9,26,18,6253,2550,2.452157,77,-15,3554,28.2,1004,6271
860,65,1994,78,22,25,38,6342,2595,2.443931,53,56,3563,27.2,968,6380
861,65,1995,100,32,38,33,7110,2768,2.568642,62,701,3772,26.6,1004,7143
862,65,1996,128,43,41,42,7512,3126,2.403071,87,324,3804,17.8,678,7554
863,65,1997,96,58,33,67,7793,3290,2.368693,63,243,3847,14.5,557,7860
864,65,1998,118,44,33,44,7791,3317,2.348809,85,-110,3905,15.1,588,7835
865,65,1999,127,43,46,21,7801,3345,2.332138,81,-94,3949,15.3,604,7822
866,65,2000,145,15,38,99,7841,3032,2.586081794,107,14,3974,23.7040765,942,7940
867,65,2001,136,59,45,99,7722,2989,2.583472733,91,-210,4014,25.53562531,1025,7821
868,65,2002,131,54,38,99,7627,2957,2.579303348,93,-188,4050,26.98765432,1093,7726
869,65,2003,118,93,36,99,7421,2884,2.573162275,82,-288,4125,30.08484848,1241,7520
870,65,2004,116,60,37,99,7317,2847,2.570073762,79,-183,4164,31.62824207,1317,7416
871,65,2005,115,65,26,99,7185,2799,2.56698821,89,-221,4210,33.51543943,1411,7284
872,65,2006,112,55,28,99,7118,2777,2.563197695,84,-151,4243,34.55102522,1466,7217
873,65,2007,119,52,53,99,7172,2803,2.558687121,66,-12,4273,34.40205944,1470,7271
874,65,2008,128,52,45,99,7170,2806,2.555238774,83,-85,4304,34.80483271,1498,7269
875,65,2009,120,25,37,99,7075,2775,2.54954955,83,-178,4285,35.23920653,1510,7174
876,67,1985,550,304,182,1243,30150,11329,2.661312,368,-47,14935,24.1,3606,31393
877,67,1986,460,194,204,1203,29587,11137,2.65664,256,-859,15223,26.8,4086,30790
878,67,1987,486,139,192,1201,29715,11213,2.650049,294,-168,15400,27.2,4187,30916
879,67,1988,456,108,196,1350,29829,11279,2.644649,260,3,15565,27.5,4286,31179
880,67,1989,427,198,198,1400,30409,11562,2.630081,229,401,15835,27,4273,31809
881,67,1990,448,245,190,1666,30800,11976,2.57181,258,399,15412,22.3,3436,32466
882,67,1991,423,264,204,1672,31739,12363,2.567257,219,726,15657,21,3294,33411
883,67,1992,439,392,205,1716,32713,12743,2.567135,234,784,15921,20,3178,34429
884,67,1993,417,467,202,1773,33825,13287,2.545721,215,954,16613,20,3326,35598
885,67,1994,419,590,235,2022,34884,13767,2.533885,184,1124,17165,19.8,3398,36906
886,67,1995,481,643,224,1856,36904,14316,2.577815,257,1597,17755,19.4,3439,38760
887,67,1996,406,514,250,2053,37651,14979,2.513586,156,788,19237,22.1,4258,39704
888,67,1997,469,465,253,2167,38151,15324,2.489624,216,398,19768,22.5,4444,40318
889,67,1998,420,514,232,2141,39032,15716,2.483584,188,667,20233,22.3,4517,41173
890,67,1999,425,401,249,2115,40642,15976,2.543941,176,1408,20747,23,4771,42757
891,67,2000,437,105,241,1825,42753,17602,2.428871719,196,1625,21117,16.64535682,3515,44578
892,67,2001,475,421,218,1828,43817,18067,2.425250457,257,810,21728,16.8492268,3661,45645
893,67,2002,458,537,246,1841,44248,18288,2.419510061,212,232,22253,17.81782232,3965,46089
894,67,2003,479,501,271,1841,44606,18475,2.414397835,208,150,22632,18.36779781,4157,46447
895,67,2004,516,737,269,1831,45095,18728,2.407891927,247,232,23259,19.48063115,4531,46926
896,67,2005,501,732,245,1839,45874,19094,2.402534828,256,531,23858,19.96814486,4764,47713
897,67,2006,564,873,302,1832,46576,19423,2.397981774,262,433,24583,20.99011512,5160,48408
898,67,2007,597,690,280,1838,47308,19758,2.3943719,317,421,25160,21.47058824,5402,49146
899,67,2008,606,692,277,1928,48145,20154,2.38885581,329,598,25719,21.63769976,5565,50073
900,67,2009,593,336,275,1910,48849,20488,2.384273721,318,368,25813,20.62914036,5325,50759
901,69,1985,2785,2619,962,8066,162658,63873,2.546585,1823,2437,72762,12.2,8889,170724
902,69,1986,2784,1937,1085,8337,166643,65821,2.53176,1699,2557,75415,12.7,9594,174980
903,69,1987,2660,1536,1015,8517,169634,67423,2.515966,1645,1526,77385,12.9,9962,178151
904,69,1988,2773,1277,992,8275,171945,68770,2.500291,1781,288,78981,12.9,10211,180220
905,69,1989,2665,1063,1042,8572,175026,70505,2.482462,1623,1755,80242,12.1,9737,183598
906,69,1990,2769,1210,1024,6524,180557,70472,2.56211,1745,1738,77811,9.4,7339,187081
907,69,1991,2699,1517,1090,6799,186743,72906,2.561422,1609,4852,79021,7.7,6115,193542
908,69,1992,2785,1905,1169,7077,192589,75342,2.556197,1616,4508,80538,6.5,5196,199666
909,69,1993,2643,2610,1132,7141,199703,77339,2.582177,1511,5667,82443,6.2,5104,206844
910,69,1994,2793,3170,1144,7387,207549,79859,2.598943,1649,6443,85053,6.1,5194,214936
911,69,1995,2779,2797,1262,7640,213982,82061,2.607597,1517,5169,88223,7,6162,221622
912,69,1996,2821,3491,1246,7998,219250,83997,2.610212,1575,4051,91020,7.7,7023,227248
913,69,1997,2784,2776,1302,8353,224443,86334,2.599706,1482,4066,94645,8.8,8311,232796
914,69,1998,2843,3222,1332,8066,231014,88543,2.60906,1511,4773,97421,9.1,8878,239080
915,69,1999,2993,3591,1432,7779,238377,91039,2.618405,1561,5515,100714,9.6,9675,246156
916,69,2000,3228,866,1431,7120,245968,97905,2.512312956,1797,5133,106267,7.86885863,8362,253088
917,69,2001,3311,3464,1523,7120,253791,101432,2.502080211,1788,6035,109883,7.690907602,8451,260911
918,69,2002,3289,3628,1516,7120,259051,103935,2.49243277,1773,3487,113808,8.675137073,9873,266171
919,69,2003,3358,3052,1531,7120,261026,105158,2.482226745,1827,148,117039,10.15131708,11881,268146
920,69,2004,3500,3030,1551,7770,265499,107379,2.472541186,1949,3174,120291,10.73397012,12912,273269
921,69,2005,3318,3290,1530,7770,268103,108816,2.463819659,1788,816,123765,12.07853594,14949,275873
922,69,2006,3511,2907,1540,7770,273257,111307,2.454984862,1971,3183,126495,12.00679869,15188,281027
923,69,2007,3517,2221,1532,7787,278967,114060,2.445791689,1985,3742,128796,11.44134911,14736,286754
924,69,2008,3425,1331,1687,7812,284582,116799,2.436510587,1738,3902,130534,10.52216281,13735,292394
925,69,2009,3566,1254,1664,7812,289690,119363,2.42696648,1902,3206,132197,9.708238462,12834,297502
926,71,1985,185,22,163,469,13772,5313,2.592133,22,-496,6645,20,1332,14241
927,71,1986,183,19,191,462,13651,5312,2.569842,-8,-120,6727,21,1415,14113
928,71,1987,191,21,197,472,13925,5456,2.552236,-6,290,6806,19.8,1350,14397
929,71,1988,183,19,162,385,13837,5459,2.534713,21,-196,6833,20.1,1374,14222
930,71,1989,155,26,161,356,13604,5410,2.514603,-6,-256,6838,20.9,1428,13960
931,71,1990,208,36,182,382,13390,5421,2.470024,26,-214,6975,22.3,1554,13772
932,71,1991,193,55,196,394,13422,5467,2.455094,-3,47,7011,22,1544,13816
933,71,1992,197,38,149,374,13655,5393,2.531986,48,165,7066,23.7,1673,14029
934,71,1993,152,39,157,389,13823,5728,2.413233,-5,188,7104,19.4,1376,14212
935,71,1994,176,59,173,432,14322,5953,2.405846,3,539,7143,16.7,1190,14754
936,71,1995,169,108,210,394,14515,6081,2.386943,-41,196,7202,15.6,1121,14909
937,71,1996,156,83,179,404,14563,6171,2.359909,-23,81,7314,15.6,1143,14967
938,71,1997,146,85,181,409,14636,6286,2.328349,-35,113,7397,15,1111,15045
939,71,1998,163,87,151,377,14677,6345,2.31316,12,-3,7482,15.2,1137,15054
940,71,1999,161,89,183,345,14797,6441,2.297314,-22,110,7569,14.9,1128,15142
941,71,2000,193,20,162,391,14895,6212,2.397778493,31,117,7647,18.76552897,1435,15286
942,71,2001,165,81,209,391,14919,6249,2.387421988,-44,68,7721,19.06488797,1472,15310
943,71,2002,172,76,184,578,15081,6344,2.37720681,-12,361,7790,18.56225931,1446,15659
944,71,2003,168,104,162,870,15219,6432,2.36613806,6,424,7887,18.44807912,1455,16089
945,71,2004,176,72,186,868,14832,6295,2.356155679,-10,-379,7953,20.84747894,1658,15700
946,71,2005,177,45,165,870,14700,6267,2.345619914,12,-142,7991,21.57427105,1724,15570
947,71,2006,189,54,171,873,14679,6287,2.334817878,18,-36,8037,21.77429389,1750,15552
948,71,2007,177,47,152,862,14663,6310,2.323771791,25,-52,8080,21.90594059,1770,15525
949,71,2008,190,60,176,866,14620,6321,2.31292517,14,-53,8161,22.54625659,1840,15486
950,71,2009,193,32,165,862,14615,6348,2.302299937,28,-37,8204,22.62311068,1856,15477
951,73,1985,76,6,51,107,4481,1872,2.393697,25,92,2296,18.5,424,4588
952,73,1986,80,2,47,103,4328,1829,2.36632,33,-190,2265,19.2,436,4431
953,73,1987,67,1,51,104,4338,1850,2.344865,16,-5,2231,17.1,381,4442
954,73,1988,81,4,62,107,4470,1923,2.324493,19,116,2235,14,312,4577
955,73,1989,56,6,47,108,4441,1933,2.297465,9,-37,2397,19.4,464,4549
956,73,1990,60,-50,53,105,4609,1817,2.536599,7,158,2204,17.6,387,4714
957,73,1991,61,40,65,585,4845,1892,2.560782,-4,720,2226,15,334,5430
958,73,1992,51,1,60,1035,4940,1930,2.559586,-9,554,2266,14.8,336,5975
959,73,1993,56,23,58,1074,4804,2051,2.342272,-2,-95,2267,9.5,216,5878
960,73,1994,59,1,52,1085,4854,2087,2.325827,7,54,2290,8.9,203,5939
961,73,1995,54,6,60,991,4992,2169,2.301522,-6,50,2291,5.3,122,5983
962,73,1996,61,16,67,1973,4139,1884,2.196921,-6,135,2297,18,413,6112
963,73,1997,56,16,60,1074,5020,2260,2.221239,-4,-14,2313,2.3,53,6094
964,73,1998,61,18,55,1068,5039,2280,2.210088,6,7,2329,2.1,49,6107
965,73,1999,52,13,65,1062,5034,2299,2.189648,-13,2,2347,2,48,6096
966,73,2000,54,3,50,1056,5107,2101,2.430747263,4,71,2403,12.5676238,302,6163
967,73,2001,52,13,61,1044,5032,2079,2.42039442,-9,-78,2412,13.80597015,333,6076
968,73,2002,59,7,63,1046,5001,2074,2.411282546,-4,-25,2413,14.04890178,339,6047
969,73,2003,62,8,60,1046,5006,2085,2.400959233,2,3,2416,13.70033113,331,6052
970,73,2004,63,5,46,1059,4848,2027,2.391711889,17,-162,2416,16.10099338,389,5907
971,73,2005,46,5,49,1072,4715,1980,2.381313131,-3,-117,2416,18.04635762,436,5787
972,73,2006,80,6,51,1077,4588,1933,2.373512675,29,-151,2416,19.99172185,483,5665
973,73,2007,61,9,56,1073,4498,1902,2.364879075,5,-99,2420,21.40495868,518,5571
974,73,2008,51,2,55,1075,4447,1888,2.355402542,-4,-45,2417,21.88663633,529,5522
975,73,2009,61,1,50,1088,4375,1865,2.345844504,11,-70,2420,22.9338843,555,5463
976,75,1985,288,12,163,624,18439,7377,2.499526,125,-455,8381,12,1004,19063
977,75,1986,264,8,154,598,17569,7144,2.459266,110,-1006,8389,14.8,1245,18167
978,75,1987,257,2,170,590,17150,7072,2.425056,87,-514,8393,15.7,1321,17740
979,75,1988,232,-7,181,500,17432,7292,2.390565,51,141,8404,13.2,1112,17932
980,75,1989,243,13,162,437,17288,7342,2.354672,81,-288,8340,12,998,17725
981,75,1990,235,4,197,387,17100,6978,2.450559,38,-276,7824,10.8,846,17487
982,75,1991,234,10,179,379,17124,7143,2.397312,55,-39,7828,8.8,685,17503
983,75,1992,242,5,186,361,17201,7218,2.38307,56,3,7838,7.9,620,17562
984,75,1993,262,8,162,418,17541,6928,2.531899,100,297,7843,11.7,915,17959
985,75,1994,238,36,136,421,18407,7194,2.55866,102,767,7851,8.4,657,18828
986,75,1995,244,85,177,470,18898,7319,2.582047,67,473,7887,7.2,568,19368
987,75,1996,244,101,174,538,19123,7366,2.596117,70,223,7972,7.6,606,19661
988,75,1997,236,108,195,619,19389,7458,2.599759,41,306,8073,7.6,615,20008
989,75,1998,258,137,178,678,19325,7366,2.623541,80,-85,8181,10,815,20003
990,75,1999,256,55,183,737,19552,7389,2.646096,73,213,8318,11.2,929,20289
991,75,2000,246,18,194,1988,18667,7621,2.449416087,52,309,8473,10.05547032,852,20655
992,75,2001,270,71,206,2322,20032,8218,2.437576053,64,1635,8531,3.668971985,313,22354
993,75,2002,250,61,204,2263,19832,8173,2.426526367,46,-305,8608,5.053438662,435,22095
994,75,2003,298,37,193,2369,20002,8273,2.41774447,105,171,8723,5.158775651,450,22371
995,75,2004,239,53,210,2324,19857,8252,2.406325739,29,-219,8805,6.28052243,553,22181
996,75,2005,223,45,202,2336,19752,8251,2.393891649,21,-114,8854,6.810481138,603,22088
997,75,2006,230,54,199,2329,19938,8369,2.382363484,31,148,8878,5.73327326,509,22267
998,75,2007,244,40,180,2454,19949,8416,2.37036597,64,72,8919,5.6396457,503,22403
999,75,2008,231,19,207,2419,19905,8442,2.357853589,24,-103,8962,5.802276278,520,22324
1000,75,2009,253,11,194,2455,20062,8552,2.345884004,59,134,8990,4.872080089,438,22517
1001,77,1985,1423,147,682,2112,85909,33295,2.580237,741,-6237,40995,18.8,7700,88021
1002,77,1986,1343,62,717,2057,83505,32661,2.556719,626,-3085,41667,21.6,9006,85562
1003,77,1987,1176,97,751,2062,83497,32895,2.538289,425,-428,42254,22.1,9359,85559
1004,77,1988,1209,169,848,1971,85317,33859,2.519773,361,1368,42417,20.2,8558,87288
1005,77,1989,1246,228,819,2163,88430,35433,2.495696,427,2878,40772,13.1,5339,90593
1006,77,1990,1281,267,818,2348,91229,36250,2.516662,463,2521,39208,7.5,2958,93577
1007,77,1991,1273,343,858,2359,93633,37531,2.494818,415,2000,39475,4.9,1944,95992
1008,77,1992,1292,563,846,2415,94996,38392,2.47437,446,973,39818,3.6,1426,97411
1009,77,1993,1344,791,864,2523,97380,39151,2.487293,480,2012,40381,3,1230,99903
1010,77,1994,1292,924,962,2505,100262,39552,2.534941,330,2534,41172,3.9,1620,102767
1011,77,1995,1304,941,920,2761,102645,40691,2.522548,384,2255,42096,3.3,1405,105406
1012,77,1996,1342,1044,1000,2806,104723,41627,2.515747,342,1781,43037,3.3,1410,107529
1013,77,1997,1363,1114,1022,2862,106900,42915,2.490971,341,1892,44081,2.6,1166,109762
1014,77,1998,1404,1286,1078,2977,109350,43781,2.497659,326,2239,45195,3.1,1414,112327
1015,77,1999,1428,1362,1012,2881,111692,44717,2.497752,416,1830,50976,12.3,6259,114573
1016,77,2000,1485,320,1109,3296,114355,46384,2.465397551,376,2705,49075,5.483443709,2691,117651
1017,77,2001,1507,1279,1184,3296,116568,47289,2.465013005,323,1890,50299,5.984214398,3010,119864
1018,77,2002,1522,1219,1161,3296,118491,48078,2.464557594,361,1562,51456,6.56483209,3378,121787
1019,77,2003,1554,1330,1231,3296,120856,49062,2.46333211,323,2042,52889,7.235909168,3827,124152
1020,77,2004,1708,1548,1200,3296,123330,50104,2.461480121,508,1966,54221,7.592999023,4117,126626
1021,77,2005,1755,1511,1232,3296,125703,51099,2.459989432,523,1850,56346,9.312107337,5247,128999
1022,77,2006,1859,1449,1270,3584,129544,52649,2.460521567,589,3540,58239,9.598379093,5590,133128
1023,77,2007,1994,1494,1210,3584,133806,54381,2.460528493,784,3478,60151,9.592525478,5770,137390
1024,77,2008,2062,1296,1353,3627,137053,55703,2.460424035,709,2581,61775,9.82921894,6072,140680
1025,77,2009,2048,753,1292,3903,140892,57258,2.460651787,756,3359,62440,8.299167201,5182,144795
1026,79,1985,16,10,4,0,836,323,2.588235,12,-40,887,63.6,564,836
1027,79,1986,12,12,5,0,771,298,2.587248,7,-72,877,66,579,771
1028,79,1987,14,7,0,0,738,285,2.589474,13,-47,868,67.2,583,738
1029,79,1988,7,3,6,0,689,265,2.6,1,-50,876,69.7,611,689
1030,79,1989,9,9,4,0,611,235,2.6,5,-83,923,74.5,688,611
1031,79,1990,5,10,6,0,558,247,2.259109,-1,-52,1201,79.4,954,558
1032,79,1991,6,11,8,0,570,238,2.394958,-2,14,1211,80.3,973,570
1033,79,1992,8,15,0,0,590,240,2.458333,8,12,1222,80.4,982,590
1034,79,1993,8,16,4,0,600,253,2.371542,4,6,1237,79.5,984,600
1035,79,1994,8,16,8,0,646,269,2.401487,0,46,1253,78.5,984,646
1036,79,1995,7,25,4,0,674,277,2.433213,3,25,1269,78.2,992,674
1037,79,1996,8,31,7,0,724,294,2.462585,1,49,1294,77.3,1000,724
1038,79,1997,6,12,4,0,744,301,2.471761,2,18,1325,77.3,1024,744
1039,79,1998,3,14,6,0,772,308,2.506494,-3,31,1337,77,1029,772
1040,79,1999,3,13,3,0,806,317,2.542587,0,34,1351,76.5,1034,806
1041,79,2000,5,3,9,1,836,381,2.194225722,-4,34,1120,65.98214286,739,837
1042,79,2001,5,14,5,1,819,376,2.178191489,0,-17,1126,66.60746004,750,820
1043,79,2002,5,15,7,1,804,373,2.155495979,-2,-13,1135,67.13656388,762,805
1044,79,2003,6,16,4,1,829,387,2.142118863,2,23,1143,66.14173228,756,830
1045,79,2004,9,17,5,1,841,398,2.113065327,4,8,1152,65.45138889,754,842
1046,79,2005,2,19,5,1,805,383,2.101827676,-3,-33,1163,67.06792777,780,806
1047,79,2006,1,24,7,1,788,379,2.079155673,-6,-11,1178,67.82682513,799,789
1048,79,2007,5,23,5,1,802,389,2.061696658,0,14,1192,67.36577181,803,803
1049,79,2008,2,20,7,1,766,376,2.037234043,-5,-31,1203,68.74480466,827,767
1050,79,2009,5,4,5,1,713,353,2.019830028,0,-53,1202,70.63227953,849,714
1051,81,1985,256,3,63,97,13189,4567,2.887891,193,-1305,5772,20.9,1205,13286
1052,81,1986,193,0,60,92,12587,4351,2.892898,133,-740,5740,24.2,1389,12679
1053,81,1987,184,7,63,85,11801,4065,2.903075,121,-914,5706,28.8,1641,11886
1054,81,1988,152,-6,81,83,11671,4005,2.914107,71,-203,5727,30.1,1722,11754
1055,81,1989,175,-12,55,82,11444,3921,2.918643,120,-348,5498,28.7,1577,11526
1056,81,1990,161,2,56,129,11225,4178,2.686692,105,-277,5235,20.2,1057,11354
1057,81,1991,176,2,67,133,11316,4327,2.615207,109,-14,5237,17.4,910,11449
1058,81,1992,138,7,85,133,11559,4319,2.676314,53,190,5239,17.6,920,11692
1059,81,1993,154,15,70,133,11664,4318,2.701251,84,21,5246,17.7,928,11797
1060,81,1994,135,17,53,135,11861,4373,2.712326,82,117,5261,16.9,888,11996
1061,81,1995,131,44,100,136,12051,4442,2.712967,31,160,5278,15.8,836,12187
1062,81,1996,141,42,66,137,12154,4484,2.710526,75,29,5371,16.5,887,12291
1063,81,1997,158,60,90,139,12433,4617,2.692874,68,213,5413,14.7,796,12572
1064,81,1998,168,34,71,139,12673,4700,2.696383,97,143,5473,14.1,773,12812
1065,81,1999,166,44,73,139,12886,4773,2.699769,93,120,5507,13.3,734,13025
1066,81,2000,180,10,97,311,12871,4987,2.580910367,83,73,5645,11.65633304,658,13182
1067,81,2001,201,40,100,311,12778,4965,2.573615307,101,-194,5712,13.07773109,747,13089
1068,81,2002,209,43,106,311,12823,4996,2.566653323,103,-58,5760,13.26388889,764,13134
1069,81,2003,175,59,102,311,12743,4980,2.558835341,73,-153,5850,14.87179487,870,13054
1070,81,2004,205,60,85,311,12752,4999,2.550910182,120,-111,5909,15.40023693,910,13063
1071,81,2005,172,69,91,311,12654,4976,2.543006431,81,-179,5978,16.76145868,1002,12965
1072,81,2006,204,73,91,311,12791,5045,2.535381566,113,24,6050,16.61157025,1005,13102
1073,81,2007,215,49,108,311,12959,5126,2.52809208,107,61,6098,15.93965235,972,13270
1074,81,2008,224,63,88,311,13135,5212,2.520145817,136,40,6160,15.38961039,948,13446
1075,81,2009,224,39,80,311,13233,5269,2.511482255,144,-46,6181,14.75489403,912,13544
1076,83,1985,345,18,109,160,19123,6390,2.992645,236,-784,7601,15.9,1211,19283
1077,83,1986,310,15,149,154,18681,6209,3.008697,161,-609,7740,19.8,1531,18835
1078,83,1987,319,6,144,148,18044,5960,3.027517,175,-818,7877,24.3,1917,18192
1079,83,1988,321,12,149,145,17965,5897,3.046464,172,-254,7904,25.4,2007,18110
1080,83,1989,316,4,163,146,18286,5973,3.061443,153,169,7675,22.2,1702,18432
1081,83,1990,278,9,159,152,18558,6762,2.744454,119,159,8050,16,1288,18710
1082,83,1991,259,18,165,150,18910,6711,2.817762,94,256,8059,16.7,1348,19060
1083,83,1992,320,23,139,155,19496,6939,2.809627,181,410,8077,14.1,1138,19651
1084,83,1993,325,79,164,168,20472,7426,2.7568,161,828,8482,12.4,1056,20640
1085,83,1994,302,56,186,172,21221,7652,2.773262,116,637,8767,12.7,1115,21393
1086,83,1995,316,57,175,171,21988,7914,2.778368,141,625,8856,10.6,942,22159
1087,83,1996,341,70,205,175,22475,8090,2.778121,136,355,9125,11.3,1035,22650
1088,83,1997,296,27,192,175,22798,8251,2.763059,104,219,9339,11.7,1088,22973
1089,83,1998,295,61,204,175,22942,8290,2.767431,91,53,9366,11.5,1076,23117
1090,83,1999,315,23,227,175,23349,8426,2.771066,88,319,9427,10.6,1001,23524
1091,83,2000,309,10,234,438,23414,9224,2.538378144,75,259,10535,12.44423351,1311,23852
1092,83,2001,305,40,242,438,23435,9283,2.524507164,63,-42,10687,13.13745672,1404,23873
1093,83,2002,330,59,278,438,23671,9429,2.510446495,52,184,10861,13.18478961,1432,24109
1094,83,2003,309,38,236,438,23940,9590,2.496350365,73,196,11014,12.92899946,1424,24378
1095,83,2004,316,26,231,438,24169,9738,2.481926474,85,144,11162,12.75757033,1424,24607
1096,83,2005,306,41,260,438,24165,9792,2.467830882,46,-50,11323,13.52115164,1531,24603
1097,83,2006,298,59,245,438,24579,10020,2.452994012,53,361,11507,12.92256887,1487,25017
1098,83,2007,348,62,236,438,24739,10144,2.438781546,112,48,11691,13.23240099,1547,25177
1099,83,2008,324,42,259,438,24762,10214,2.424319561,65,-42,11861,13.88584436,1647,25200
1100,83,2009,320,19,256,438,24927,10343,2.410035773,64,101,11994,13.76521594,1651,25365
1101,85,1985,348,108,238,441,23948,9155,2.615838,110,-692,10891,15.9,1736,24389
1102,85,1986,300,83,200,436,23397,9097,2.571947,100,-656,11040,17.6,1943,23833
1103,85,1987,276,62,228,443,23379,9235,2.531565,48,-59,11163,17.3,1928,23822
1104,85,1988,299,90,222,451,23636,9483,2.49246,77,188,11251,15.7,1768,24087
1105,85,1989,286,81,238,460,23821,9721,2.450468,48,146,11340,14.3,1619,24281
1106,85,1990,342,104,227,395,24144,9405,2.567145,115,143,10353,9.2,948,24539
1107,85,1991,319,127,244,412,24863,9833,2.528526,75,661,10457,6,624,25275
1108,85,1992,318,182,254,432,25791,10240,2.518652,64,884,10584,3.3,344,26223
1109,85,1993,362,257,254,446,26841,10426,2.574429,108,956,10766,3.2,340,27287
1110,85,1994,390,364,250,455,28047,10680,2.626124,140,1075,11023,3.1,343,28502
1111,85,1995,423,258,264,491,29179,11115,2.625191,159,1009,11387,2.4,272,29670
1112,85,1996,434,224,278,517,29970,11446,2.618382,156,661,11645,1.7,199,30487
1113,85,1997,481,213,293,530,30722,11783,2.607316,188,577,11869,0.7,86,31252
1114,85,1998,421,292,327,530,31307,11977,2.613927,94,491,12082,0.9,105,31837
1115,85,1999,438,320,302,530,32218,12242,2.631759,136,775,12393,1.2,151,32748
1116,85,2000,435,75,296,550,33027,13109,2.519414143,139,688,14292,8.277357962,1183,33577
1117,85,2001,469,300,314,550,33892,13474,2.515362921,155,710,14563,7.477854838,1089,34442
1118,85,2002,500,373,352,550,34376,13699,2.509380247,148,336,14924,8.208255159,1225,34926
1119,85,2003,449,295,345,550,35090,14020,2.502853067,104,610,15407,9.002401506,1387,35640
1120,85,2004,469,359,349,550,35581,14247,2.497438057,120,371,15783,9.731990116,1536,36131
1121,85,2005,515,486,309,550,36447,14622,2.49261387,206,660,16217,9.835357958,1595,36997
1122,85,2006,506,583,362,550,37418,15050,2.486245847,144,827,16877,10.82538366,1827,37968
1123,85,2007,504,536,364,550,38581,15550,2.481093248,140,1023,17478,11.03101041,1928,39131
1124,85,2008,563,369,404,550,39402,15908,2.476866985,159,662,17877,11.01415226,1969,39952
1125,85,2009,554,189,368,550,40130,16222,2.473801011,186,542,18083,10.29143394,1861,40680
1126,87,1985,430,33,218,367,22064,8353,2.641446,212,-594,9588,12.9,1235,22431
1127,87,1986,370,79,223,354,21154,8105,2.609994,147,-1070,9622,15.8,1517,21508
1128,87,1987,349,9,230,360,21318,8249,2.584313,119,51,9701,15,1452,21678
1129,87,1988,371,8,233,362,21469,8386,2.5601,138,15,9722,13.7,1336,21831
1130,87,1989,386,5,202,360,21535,8492,2.535916,184,-120,9975,14.9,1483,21895
1131,87,1990,342,9,219,456,21600,8139,2.653889,123,38,9230,11.8,1091,22056
1132,87,1991,361,28,202,475,22228,8502,2.614444,159,488,9239,8,737,22703
1133,87,1992,392,55,246,495,22987,8812,2.608602,146,633,9267,4.9,455,23482
1134,87,1993,401,51,256,498,23743,8702,2.728453,145,614,9322,6.7,620,24241
1135,87,1994,448,191,239,518,24570,9139,2.688478,209,638,9373,2.5,234,25088
1136,87,1995,421,98,241,525,24837,9251,2.684791,180,94,9564,3.3,313,25362
1137,87,1996,451,104,214,542,25500,9516,2.679697,237,443,9690,1.8,174,26042
1138,87,1997,512,127,231,552,26095,9755,2.675038,281,324,9805,0.5,50,26647
1139,87,1998,465,186,238,552,26110,9765,2.673835,227,-212,9932,1.7,167,26662
1140,87,1999,540,108,225,552,26401,9877,2.672978,315,-24,10118,2.4,241,26953
1141,87,2000,465,28,232,484,26767,9578,2.794633535,233,64,10440,8.256704981,862,27251
1142,87,2001,475,113,276,484,26991,9696,2.783725248,199,25,10569,8.260005677,873,27475
1143,87,2002,482,94,251,484,27178,9806,2.771568427,231,-44,10679,8.174922746,873,27662
1144,87,2003,494,135,233,484,27371,9915,2.760564801,261,-68,10825,8.406466513,910,27855
1145,87,2004,414,122,226,479,27433,9979,2.749073053,188,-131,10964,8.983947464,985,27912
1146,87,2005,439,139,240,580,27367,9998,2.737247449,199,-164,11117,10.0656652,1119,27947
1147,87,2006,414,129,246,715,27268,10005,2.725437281,168,-132,11262,11.16142781,1257,27983
1148,87,2007,415,82,233,674,27174,10017,2.71278826,182,-317,11360,11.8221831,1343,27848
1149,87,2008,421,52,278,705,27041,10011,2.701128758,143,-245,11430,12.41469816,1419,27746
1150,87,2009,444,27,192,746,27280,10144,2.689274448,252,28,11463,11.50658641,1319,28026
1151,89,1985,348,6,255,517,21243,8064,2.634301,93,-172,9181,12.2,1117,21760
1152,89,1986,359,-10,212,514,20943,8042,2.604203,147,-450,9256,13.1,1214,21457
1153,89,1987,334,4,238,516,20398,7913,2.577783,96,-639,9312,15,1399,20914
1154,89,1988,322,11,237,445,20400,7995,2.551595,85,-154,9324,14.3,1329,20845
1155,89,1989,322,-2,218,454,20014,7932,2.523197,104,-481,9322,14.9,1390,20468
1156,89,1990,296,2,230,493,19717,7593,2.596734,66,-324,8739,13.1,1146,20210
1157,89,1991,287,9,223,502,19871,7523,2.641366,64,99,8741,13.9,1218,20373
1158,89,1992,318,18,250,546,19748,7820,2.52532,68,-147,8750,10.6,930,20294
1159,89,1993,346,3,238,543,19892,7768,2.560762,108,33,8768,11.4,1000,20435
1160,89,1994,299,4,248,535,19955,7816,2.553096,51,4,8771,10.9,955,20490
1161,89,1995,300,51,260,549,20146,7934,2.539198,40,165,8775,9.6,841,20695
1162,89,1996,271,29,252,611,20136,7984,2.522044,19,33,8826,9.5,842,20747
1163,89,1997,292,40,260,688,20079,8061,2.490882,32,-12,8855,9,794,20767
1164,89,1998,258,32,235,717,19799,7988,2.478593,23,-274,8895,10.2,907,20516
1165,89,1999,288,29,214,746,19653,7965,2.46742,74,-191,8927,10.8,962,20399
1166,89,2000,281,10,228,568,19675,7901,2.490191115,53,-218,8821,10.4296565,920,20243
1167,89,2001,298,41,217,568,19332,7798,2.479097204,81,-424,8852,11.90691369,1054,19900
1168,89,2002,322,35,247,568,19056,7723,2.467434935,75,-351,8875,12.98028169,1152,19624
1169,89,2003,296,21,227,568,19099,7776,2.456147119,69,-26,8886,12.49155976,1110,19667
1170,89,2004,291,44,216,568,18993,7768,2.445030896,75,-181,8920,12.91479821,1152,19561
1171,89,2005,300,21,245,568,18802,7724,2.434230968,55,-246,8931,13.514724,1207,19370
1172,89,2006,232,13,223,568,18625,7688,2.42260666,9,-186,8933,13.9370872,1245,19193
1173,89,2007,255,21,216,568,18369,7617,2.411579362,39,-295,8945,14.84628284,1328,18937
1174,89,2008,280,37,265,568,18285,7619,2.39992125,15,-99,8971,15.07078364,1352,18853
1175,89,2009,230,6,229,568,18276,7650,2.389019608,1,-10,8973,14.7442327,1323,18844
1176,91,1985,33,13,10,0,2130,776,2.744845,23,-89,1496,48.1,720,2130
1177,91,1986,20,29,16,0,1999,724,2.76105,4,-135,1508,52,784,1999
1178,91,1987,24,27,16,0,2151,776,2.771907,8,144,1536,49.5,760,2151
1179,91,1988,26,29,18,0,2219,777,2.855856,8,60,1565,50.4,788,2219
1180,91,1989,22,32,10,0,2262,810,2.792593,12,31,1613,49.8,803,2262
1181,91,1990,23,32,15,3,2312,947,2.441394,8,45,1507,37.2,560,2315
1182,91,1991,31,37,14,3,2416,1014,2.382643,17,87,1539,34.1,525,2419
1183,91,1992,29,66,25,3,2532,1101,2.299727,4,112,1576,30.1,475,2535
1184,91,1993,21,70,16,3,2650,1082,2.449168,5,113,1642,34.1,560,2653
1185,91,1994,27,90,11,4,2898,1174,2.468484,16,233,1712,31.4,538,2902
1186,91,1995,30,96,19,4,3081,1247,2.47073,11,172,1802,30.8,555,3085
1187,91,1996,25,108,17,4,3248,1316,2.468085,8,159,1898,30.7,582,3252
1188,91,1997,31,58,17,4,3318,1348,2.461424,14,56,2006,32.8,658,3322
1189,91,1998,35,67,17,4,3449,1397,2.468862,18,113,2064,32.3,667,3453
1190,91,1999,38,68,24,4,3614,1461,2.473648,14,151,2131,31.4,670,3618
1191,91,2000,26,16,20,18,3757,1592,2.359924623,6,142,2162,26.36447734,570,3775
1192,91,2001,40,64,25,18,3791,1618,2.343016069,15,19,2233,27.54142409,615,3809
1193,91,2002,31,88,15,18,3885,1672,2.323564593,16,78,2328,28.17869416,656,3903
1194,91,2003,31,83,26,18,3887,1685,2.306824926,5,-3,2431,30.6869601,746,3905
1195,91,2004,35,107,26,18,4005,1748,2.291189931,9,109,2566,31.87840998,818,4023
1196,91,2005,35,100,23,18,4066,1788,2.274049217,12,49,2688,33.48214286,900,4084
1197,91,2006,38,88,26,18,4119,1823,2.259462425,12,41,2852,36.0799439,1029,4137
1198,91,2007,40,65,29,18,4256,1898,2.242360379,11,126,2958,35.83502366,1060,4274
1199,91,2008,42,61,21,18,4389,1973,2.224531171,21,112,3036,35.01317523,1063,4407
1200,91,2009,26,35,21,18,4354,1973,2.206791688,5,-40,3066,35.64905414,1093,4372
1201,93,1985,101,228,31,14,6587,2178,3.024334,70,-229,6600,67,4422,6601
1202,93,1986,122,183,25,15,6845,2245,3.048998,97,162,6826,67.1,4581,6860
1203,93,1987,95,131,41,14,6923,2248,3.079626,54,23,7007,67.9,4759,6937
1204,93,1988,101,122,35,14,6879,2213,3.10845,66,-110,7145,69,4932,6893
1205,93,1989,90,109,28,14,7040,2251,3.127499,62,99,7163,68.6,4912,7054
1206,93,1990,92,124,27,0,7269,2775,2.619459,65,150,7247,61.7,4472,7269
1207,93,1991,108,97,26,0,7700,2895,2.659758,82,349,7371,60.7,4476,7700
1208,93,1992,83,182,35,0,8092,3078,2.62898,48,344,7468,58.8,4390,8092
1209,93,1993,114,298,34,0,8581,3341,2.568393,80,409,7650,56.3,4309,8581
1210,93,1994,105,426,37,0,9526,3694,2.578776,68,877,7948,53.5,4254,9526
1211,93,1995,146,452,38,0,10577,4114,2.570977,108,943,8374,50.9,4260,10577
1212,93,1996,135,468,42,0,11377,4448,2.557779,93,707,8826,49.6,4378,11377
1213,93,1997,130,446,40,0,12362,4880,2.533197,90,895,9294,47.5,4414,12362
1214,93,1998,147,345,51,0,13065,5168,2.528057,96,607,9740,46.9,4572,13065
1215,93,1999,178,388,43,0,13900,5513,2.521313,135,700,10085,45.3,4572,13900
1216,93,2000,149,105,65,70,14659,5992,2.446428571,84,741,10810,44.56984274,4818,14729
1217,93,2001,168,422,55,70,15102,6223,2.426803792,113,330,11265,44.75810031,5042,15172
1218,93,2002,170,380,70,70,15347,6382,2.404732059,100,145,11679,45.35491052,5297,15417
1219,93,2003,173,338,67,70,15719,6595,2.383472328,106,266,12054,45.28787125,5459,15789
1220,93,2004,149,292,72,70,15843,6704,2.36321599,77,47,12384,45.86563307,5680,15913
1221,93,2005,166,313,58,70,15991,6824,2.343347011,108,40,12739,46.43221603,5915,16061
1222,93,2006,161,281,65,70,16058,6915,2.32219812,96,-29,13063,47.06422721,6148,16128
1223,93,2007,150,306,71,70,16266,7065,2.302335456,79,129,13412,47.32329257,6347,16336
1224,93,2008,135,227,71,70,16208,7104,2.281531532,64,-122,13684,48.08535516,6580,16278
1225,93,2009,149,154,64,70,15901,7033,2.260912839,85,-392,13833,49.15781103,6800,15971
1226,95,1985,61,3,60,59,4362,1794,2.431438,1,-10,2118,15.3,324,4421
1227,95,1986,73,6,47,59,4386,1828,2.399343,26,-2,2131,14.2,303,4445
1228,95,1987,45,4,56,59,4352,1834,2.372955,-11,-23,2147,14.6,313,4411
1229,95,1988,54,0,37,59,4273,1821,2.346513,17,-96,2153,15.4,332,4332
1230,95,1989,52,5,51,90,4159,1799,2.31184,1,-84,2114,14.9,315,4249
1231,95,1990,59,6,53,65,4123,1712,2.408294,6,-67,1960,12.7,248,4188
1232,95,1991,56,2,57,67,4142,1789,2.31526,-1,22,1966,9,177,4209
1233,95,1992,46,7,55,69,4162,1830,2.274317,-9,31,1968,7,138,4231
1234,95,1993,55,7,56,68,4310,1798,2.397108,-1,148,1975,9,177,4378
1235,95,1994,48,6,76,69,4332,1806,2.398671,-28,51,1982,8.9,176,4401
1236,95,1995,52,8,37,70,4409,1841,2.394894,15,63,1988,7.4,147,4479
1237,95,1996,70,15,52,70,4434,1863,2.380032,18,7,1996,6.7,133,4504
1238,95,1997,51,19,55,71,4503,1910,2.357592,-4,74,2011,5,101,4574
1239,95,1998,61,14,64,71,4499,1912,2.353034,-3,-1,2030,5.8,118,4570
1240,95,1999,58,20,46,71,4447,1895,2.346702,12,-64,2044,7.3,149,4518
1241,95,2000,64,2,50,89,4363,1771,2.463579898,14,-81,2016,12.15277778,245,4452
1242,95,2001,52,9,55,89,4398,1790,2.45698324,-3,38,2023,11.5175482,233,4487
1243,95,2002,58,13,56,89,4407,1797,2.452420701,2,7,2035,11.6953317,238,4496
1244,95,2003,57,9,53,89,4388,1793,2.447295036,4,-23,2042,12.19392752,249,4477
1245,95,2004,71,9,63,89,4491,1839,2.442088091,8,95,2049,10.2489019,210,4580
1246,95,2005,69,13,38,89,4459,1830,2.436612022,31,-63,2059,11.12190384,229,4548
1247,95,2006,58,9,51,89,4415,1817,2.429829389,7,-51,2067,12.09482342,250,4504
1248,95,2007,72,8,37,89,4395,1812,2.425496689,35,-55,2073,12.59044863,261,4484
1249,95,2008,53,6,58,89,4362,1802,2.420643729,-5,-28,2077,13.24025036,275,4451
1250,95,2009,47,3,44,89,4365,1808,2.414269912,3,0,2083,13.20211234,275,4454
1251,97,1985,144,39,27,21,11295,5458,2.069439,117,420,9432,42.1,3974,11316
1252,97,1986,181,60,33,23,11945,5900,2.024576,148,504,9468,37.7,3568,11968
1253,97,1987,159,99,27,23,12019,6060,1.983333,132,-58,9553,36.6,3493,12042
1254,97,1988,153,112,25,23,12069,6240,1.934135,128,-78,9657,35.4,3417,12092
1255,97,1989,168,162,21,24,12391,6652,1.862748,147,176,9762,31.9,3110,12415
1256,97,1990,132,153,26,120,12571,5877,2.139016,106,170,9837,40.3,3960,12691
1257,97,1991,146,65,32,120,12862,5971,2.154078,114,177,9990,40.2,4019,12982
1258,97,1992,170,104,23,123,13248,6159,2.150999,147,242,10076,38.9,3917,13371
1259,97,1993,128,138,42,130,13931,6439,2.163535,86,604,10183,36.8,3744,14061
1260,97,1994,167,192,38,135,14404,6615,2.177475,129,349,10321,35.9,3706,14539
1261,97,1995,141,92,32,134,14518,6655,2.181518,109,4,10513,36.7,3858,14652
1262,97,1996,144,180,37,132,14421,6599,2.185331,107,-206,10605,37.8,4006,14553
1263,97,1997,150,197,39,133,14654,6730,2.177415,111,123,10785,37.6,4055,14787
1264,97,1998,136,174,30,133,14648,6702,2.185616,106,-112,11165,40,4463,14781
1265,97,1999,145,280,29,133,14700,6702,2.193375,116,-64,11339,40.9,4637,14833
1266,97,2000,176,72,43,328,15436,7248,2.129690949,133,804,11901,39.09755483,4653,15764
1267,97,2001,165,287,48,328,15856,7446,2.129465485,117,303,12117,38.54914583,4671,16184
1268,97,2002,170,120,32,328,15773,7410,2.128609987,138,-221,12166,39.09255302,4756,16101
1269,97,2003,166,134,44,328,15947,7492,2.128537106,122,52,12229,38.73579197,4737,16275
1270,97,2004,155,113,39,328,15749,7401,2.127955682,116,-314,12272,39.69198175,4871,16077
1271,97,2005,172,118,50,328,15808,7432,2.127018299,122,-63,12356,39.85108449,4924,16136
1272,97,2006,157,147,35,328,15759,7411,2.12643368,122,-171,12485,40.64076892,5074,16087
1273,97,2007,166,211,40,328,15908,7485,2.125317301,126,23,12653,40.8440686,5168,16236
1274,97,2008,162,168,43,328,16345,7703,2.121900558,119,318,12920,40.37925697,5217,16673
1275,97,2009,171,115,44,328,16725,7889,2.120040563,127,253,12979,39.21719701,5090,17053
1276,99,1985,318,21,120,163,14211,5205,2.730259,198,-126,6097,14.6,892,14374
1277,99,1986,273,35,126,160,13968,5142,2.716453,147,-393,6133,16.2,991,14128
1278,99,1987,245,-4,148,158,13828,5106,2.708186,97,-239,6183,17.4,1077,13986
1279,99,1988,243,-3,121,169,14062,5208,2.700077,122,123,6188,15.8,980,14231
1280,99,1989,207,-1,115,151,13568,5046,2.688863,92,-604,6180,18.3,1134,13719
1281,99,1990,221,-1,115,186,13051,4984,2.618579,106,-588,5855,14.9,871,13237
1282,99,1991,219,-2,116,183,12775,4934,2.589177,103,-382,5854,15.7,920,12958
1283,99,1992,214,-4,116,155,12950,4914,2.635328,98,49,5852,16,938,13105
1284,99,1993,209,0,124,180,13242,4983,2.657435,85,232,5848,14.8,865,13422
1285,99,1994,228,7,105,166,13520,5065,2.669299,123,141,5848,13.4,783,13686
1286,99,1995,214,5,105,214,13609,5091,2.673149,109,28,5855,13,764,13823
1287,99,1996,209,14,135,219,13783,5160,2.671124,74,105,5866,12,706,14002
1288,99,1997,220,58,104,198,13919,5241,2.655791,116,-1,5947,11.9,706,14117
1289,99,1998,208,54,136,211,14013,5267,2.660528,72,35,6005,12.3,738,14224
1290,99,1999,212,93,124,224,14148,5306,2.666415,88,60,6059,12.4,753,14372
1291,99,2000,240,4,136,300,14153,5306,2.667357708,104,-23,5980,11.27090301,674,14453
1292,99,2001,269,17,141,300,13809,5213,2.648954537,128,-472,5987,12.92801069,774,14109
1293,99,2002,247,13,146,300,13711,5217,2.628138777,101,-199,5986,12.84664217,769,14011
1294,99,2003,242,15,120,300,13522,5181,2.609920865,122,-311,6000,13.65,819,13822
1295,99,2004,204,8,126,300,13356,5157,2.589877836,78,-244,5997,14.0070035,840,13656
1296,99,2005,233,8,103,300,13210,5137,2.571539809,130,-276,5994,14.29763096,857,13510
1297,99,2006,187,11,99,300,12908,5058,2.551996837,88,-390,5997,15.65782891,939,13208
1298,99,2007,189,3,131,300,12472,4925,2.532385787,58,-494,5958,17.3380329,1033,12772
1299,99,2008,190,10,128,300,12382,4926,2.513601299,62,-152,5951,17.22399597,1025,12682
1300,99,2009,191,0,146,300,12276,4924,2.493095045,45,-151,5948,17.21587088,1024,12576
1301,101,1985,1844,272,1127,2613,119294,46877,2.54483,717,-1205,51045,8.2,4168,121907
1302,101,1986,1781,264,1126,2643,119722,47816,2.503806,655,-197,51414,7,3598,122365
1303,101,1987,1780,308,1205,2975,119863,48558,2.46845,575,-102,51775,6.2,3217,122838
1304,101,1988,1752,274,1192,2149,121588,49946,2.434389,560,339,52116,4.2,2170,123737
1305,101,1989,1625,147,1159,2143,121220,50569,2.397121,466,-840,52635,3.9,2066,123363
1306,101,1990,1771,167,1220,2915,119963,47057,2.549313,551,-1036,50872,7.5,3815,122878
1307,101,1991,1764,160,1242,2982,120504,48190,2.500602,522,86,51039,5.6,2849,123486
1308,101,1992,1805,228,1259,2975,121435,48410,2.508469,546,378,51199,5.4,2789,124410
1309,101,1993,1780,364,1169,3025,123323,48120,2.562822,611,1327,51544,6.6,3424,126348
1310,101,1994,1746,645,1236,3136,125586,48828,2.572008,510,1864,51949,6,3121,128722
1311,101,1995,1730,938,1337,3185,127647,49254,2.591607,393,1717,52292,5.8,3038,130832
1312,101,1996,1734,1193,1260,3353,129145,49821,2.59218,474,1192,53330,6.6,3509,132498
1313,101,1997,1739,1139,1359,3467,131327,50909,2.579642,380,1916,54717,7,3808,134794
1314,101,1998,1869,1351,1352,3498,133883,51749,2.587161,517,2070,56103,7.8,4354,137381
1315,101,1999,1933,1437,1374,3529,136189,52510,2.593582,559,1778,57454,8.6,4944,139718
1316,101,2000,1927,267,1380,4135,137719,54760,2.514956172,547,1589,59196,7.493749578,4436,141854
1317,101,2001,2004,1067,1393,4081,139915,55754,2.509506044,611,1531,60453,7.772980663,4699,143996
1318,101,2002,1985,1353,1482,4185,142296,56821,2.504285387,503,1982,61792,8.044730709,4971,146481
1319,101,2003,2060,1265,1451,4032,143940,57613,2.49839446,609,882,63222,8.871911676,5609,147972
1320,101,2004,1946,1249,1526,3974,144746,58060,2.493041681,420,328,64483,9.960764853,6423,148720
1321,101,2005,1993,1189,1546,3975,145994,58699,2.487163325,447,802,65740,10.7103742,7041,149969
1322,101,2006,2014,1135,1412,3930,148134,59689,2.481763809,602,1493,66899,10.77744062,7210,152064
1323,101,2007,2143,1237,1509,4202,150557,60810,2.475859234,634,2061,68087,10.6877965,7277,154759
1324,101,2008,2167,642,1608,4111,152141,61613,2.46930031,559,934,68803,10.45012572,7190,156252
1325,101,2009,2038,399,1558,4142,153182,62213,2.462218507,480,592,69140,10.01880243,6927,157324
1326,103,1985,127,0,37,261,6329,2071,3.056012,90,-441,3019,31.4,948,6590
1327,103,1986,103,38,30,257,6183,2006,3.082253,73,-223,3024,33.7,1018,6440
1328,103,1987,96,9,37,240,6188,1995,3.101754,59,-71,3052,34.6,1057,6428
1329,103,1988,92,5,38,253,6046,1927,3.137519,54,-183,3066,37.1,1139,6299
1330,103,1989,89,4,30,217,5894,1861,3.167114,59,-247,3027,38.5,1166,6111
1331,103,1990,76,8,38,232,5829,2180,2.673853,38,-88,2803,22.2,623,6061
1332,103,1991,86,10,32,132,5895,2263,2.604949,54,-88,2811,19.5,548,6027
1333,103,1992,70,21,36,172,6008,2310,2.600866,34,119,2809,17.8,499,6180
1334,103,1993,73,22,45,253,6006,2373,2.530973,28,51,2830,16.1,457,6259
1335,103,1994,65,15,39,226,6088,2437,2.498153,26,29,2852,14.6,415,6314
1336,103,1995,72,17,40,242,6161,2512,2.452627,32,57,2867,12.4,355,6403
1337,103,1996,66,14,44,203,6138,2552,2.405172,22,-84,2884,11.5,332,6341
1338,103,1997,59,16,48,152,6170,2629,2.3469,11,-30,2898,9.3,269,6322
1339,103,1998,62,15,45,161,6071,2634,2.30486,17,-107,2914,9.6,280,6232
1340,103,1999,78,18,56,170,5921,2617,2.262514,22,-163,2929,10.7,312,6091
1341,103,2000,65,4,47,232,5737,2299,2.495432797,18,-142,2859,19.58726828,560,5969
1342,103,2001,66,17,57,232,5648,2270,2.488105727,9,-98,2887,21.37166609,617,5880
1343,103,2002,67,24,40,232,5704,2299,2.48107873,27,29,2919,21.24015074,620,5936
1344,103,2003,75,17,35,232,5623,2274,2.472735268,40,-121,2952,22.96747967,678,5855
1345,103,2004,76,22,47,232,5672,2298,2.468233246,29,20,3004,23.50199734,706,5904
1346,103,2005,75,38,58,232,5586,2269,2.461877479,17,-103,3052,25.65530799,783,5818
1347,103,2006,93,47,50,232,5749,2342,2.454739539,43,120,3106,24.59755312,764,5981
1348,103,2007,100,47,52,232,5861,2392,2.450250836,48,64,3171,24.56638284,779,6093
1349,103,2008,109,74,43,232,5928,2428,2.441515651,66,1,3253,25.36120504,825,6160
1350,103,2009,90,62,40,232,6085,2500,2.434,50,107,3292,24.05832321,792,6317
1351,105,1985,240,0,115,279,11267,3959,2.845921,125,68,4879,18.9,920,11546
1352,105,1986,219,5,95,288,11618,4104,2.830897,124,236,4910,16.4,806,11906
1353,105,1987,193,0,115,284,11474,4071,2.818472,78,-226,4949,17.7,878,11758
1354,105,1988,181,36,107,279,11299,4025,2.807205,74,-254,4957,18.8,932,11578
1355,105,1989,195,78,98,262,10847,3887,2.790584,97,-566,4975,21.9,1088,11109
1356,105,1990,154,-3,98,198,10570,3930,2.689567,56,-397,5277,25.5,1347,10768
1357,105,1991,184,29,112,205,10630,4095,2.595849,72,-5,5274,22.4,1179,10835
1358,105,1992,170,18,122,201,10739,4284,2.506769,48,57,5303,19.2,1019,10940
1359,105,1993,182,30,101,207,11004,4143,2.656046,81,190,5321,22.1,1178,11211
1360,105,1994,157,6,109,210,11251,4233,2.657926,48,202,5351,20.9,1118,11461
1361,105,1995,154,113,115,215,11483,4327,2.653802,39,198,5357,19.2,1030,11698
1362,105,1996,159,132,104,218,11602,4386,2.645235,55,67,5470,19.8,1084,11820
1363,105,1997,158,116,131,222,11744,4504,2.60746,27,119,5602,19.6,1098,11966
1364,105,1998,167,97,108,222,11901,4568,2.605298,59,98,5718,20.1,1150,12123
1365,105,1999,166,94,109,242,12047,4636,2.598576,57,109,5815,20.3,1179,12289
1366,105,2000,189,30,113,251,12178,4713,2.583916826,76,65,6026,21.7889147,1313,12429
1367,105,2001,178,120,132,251,12155,4725,2.572486772,46,-69,6117,22.75625307,1392,12406
1368,105,2002,175,89,134,251,12158,4747,2.561196545,41,-38,6195,23.37368846,1448,12409
1369,105,2003,174,86,127,251,12368,4853,2.548526685,47,163,6265,22.53790902,1412,12619
1370,105,2004,173,98,130,251,12573,4955,2.537436932,43,162,6332,21.74668351,1377,12824
1371,105,2005,184,97,133,251,12445,4928,2.52536526,51,-179,6439,23.46637677,1511,12696
1372,105,2006,191,68,119,251,12188,4849,2.51350794,72,-329,6496,25.35406404,1647,12439
1373,105,2007,147,60,138,251,11916,4763,2.50178459,9,-281,6568,27.4817296,1805,12167
1374,105,2008,157,47,122,251,11854,4765,2.48772298,35,-97,6614,27.95585122,1849,12105
1375,105,2009,159,42,125,251,11744,4742,2.476592155,34,-144,6635,28.53051997,1893,11995
1376,107,1985,222,62,62,126,14070,5596,2.514296,160,-216,9111,38.6,3515,14196
1377,107,1986,206,28,55,125,13738,5546,2.477101,151,-484,9165,39.5,3619,13863
1378,107,1987,181,96,60,126,13736,5615,2.446305,121,-122,9186,38.9,3571,13862
1379,107,1988,199,66,47,126,13639,5647,2.415265,152,-249,9292,39.2,3645,13765
1380,107,1989,220,122,53,129,13821,5805,2.380878,167,18,9291,37.5,3486,13950
1381,107,1990,198,187,50,165,14007,5483,2.554623,148,74,9252,40.7,3769,14172
1382,107,1991,198,130,40,158,14573,5525,2.637647,158,401,9439,41.5,3914,14731
1383,107,1992,171,223,62,153,14996,5533,2.710284,109,309,9569,42.2,4036,15149
1384,107,1993,196,287,71,188,15736,6069,2.592849,125,650,9792,38,3723,15924
1385,107,1994,184,448,59,195,16422,6293,2.609566,125,568,10079,37.6,3786,16617
1386,107,1995,169,443,66,210,17044,6495,2.624172,103,534,10527,38.3,4032,17254
1387,107,1996,177,346,56,209,17509,6644,2.63531,121,343,10970,39.4,4326,17718
1388,107,1997,179,300,70,210,17907,6809,2.629902,109,290,11316,39.8,4507,18117
1389,107,1998,179,508,57,263,18343,6886,2.663811,122,367,11616,40.7,4730,18606
1390,107,1999,202,480,70,316,18908,7107,2.660475,132,486,12130,41.4,5023,19224
1391,107,2000,226,128,51,257,19866,8184,2.427419355,175,716,12063,32.15618005,3879,20123
1392,107,2001,204,512,81,257,20179,8327,2.423321725,123,190,12534,33.56470401,4207,20436
1393,107,2002,222,275,69,257,20635,8527,2.419960127,153,303,12939,34.09846201,4412,20892
1394,107,2003,235,221,67,257,20871,8647,2.413390379,168,68,13137,34.17066301,4489,21128
1395,107,2004,229,313,61,257,21036,8739,2.407140405,168,-3,13443,34.99218924,4704,21293
1396,107,2005,239,347,68,257,21196,8831,2.40018118,171,-11,13856,36.2658776,5025,21453
1397,107,2006,249,459,91,330,21556,9001,2.394845017,158,275,14429,37.61868459,5428,21886
1398,107,2007,258,405,88,337,22078,9240,2.389393939,170,359,14838,37.72745653,5598,22415
1399,107,2008,267,568,95,337,22594,9484,2.382328132,172,344,15517,38.87993813,6033,22931
1400,107,2009,260,376,88,337,22988,9673,2.37651194,172,222,16143,40.07929133,6470,23325
1401,109,1985,73,2,34,17,4383,1397,3.137437,39,-33,2067,32.4,670,4400
1402,109,1986,81,2,41,18,4580,1445,3.16955,40,158,2071,30.2,626,4598
1403,109,1987,87,0,31,18,4767,1482,3.216599,56,131,2075,28.6,593,4785
1404,109,1988,65,14,27,17,4646,1424,3.26264,38,-160,2079,31.5,655,4663
1405,109,1989,75,0,33,16,4623,1400,3.302143,42,-66,2284,38.7,884,4639
1406,109,1990,87,0,31,90,4554,1643,2.771759,56,-51,2306,28.8,663,4644
1407,109,1991,87,0,41,95,4637,1758,2.637656,46,42,2306,23.8,548,4732
1408,109,1992,80,20,35,98,4690,1779,2.636312,45,11,2306,22.9,527,4788
1409,109,1993,85,1,31,96,4730,1766,2.678369,54,-16,2326,24.1,560,4826
1410,109,1994,79,69,31,100,4842,1817,2.664832,48,68,2327,21.9,510,4942
1411,109,1995,62,48,39,110,5160,1958,2.635342,23,305,2396,18.3,438,5270
1412,109,1996,85,67,31,117,5308,2025,2.621235,54,101,2444,17.1,419,5425
1413,109,1997,80,136,37,122,5370,2082,2.579251,43,24,2511,17.1,429,5492
1414,109,1998,86,105,46,122,5436,2130,2.552113,40,26,2647,19.5,517,5558
1415,109,1999,84,119,43,122,5643,2174,2.595676,41,166,2752,21,578,5765
1416,109,2000,85,33,51,36,5947,2331,2.551265551,34,177,3118,25.24053881,787,5983
1417,109,2001,73,130,47,36,6047,2398,2.521684737,26,74,3244,26.07891492,846,6083
1418,109,2002,96,103,53,36,6209,2489,2.495578778,43,119,3342,25.55356074,854,6245
1419,109,2003,97,75,40,36,6243,2526,2.471496437,57,-23,3411,25.94547054,885,6279
1420,109,2004,84,82,35,36,6204,2527,2.455085081,49,-88,3493,27.65531062,966,6240
1421,109,2005,74,103,35,36,6248,2572,2.429237947,39,5,3590,28.35654596,1018,6284
1422,109,2006,99,77,38,36,6205,2580,2.40503876,61,-104,3659,29.4889314,1079,6241
1423,109,2007,80,72,38,36,6123,2566,2.386204209,42,-124,3736,31.31691649,1170,6159
1424,109,2008,59,62,48,36,6140,2599,2.362447095,11,6,3791,31.44289106,1192,6176
1425,109,2009,73,42,47,36,6090,2600,2.342307692,26,-76,3820,31.93717277,1220,6126
1426,111,1985,24,0,5,0,763,310,2.46129,19,-174,529,41.4,219,763
1427,111,1986,10,-1,6,0,754,310,2.432258,4,-13,529,41.4,219,754
1428,111,1987,17,2,4,0,811,337,2.406528,13,44,528,36.2,191,811
1429,111,1988,10,-1,0,0,747,313,2.386581,8,-74,531,41.1,218,747
1430,111,1989,7,-1,4,0,746,318,2.345912,3,-4,521,39,203,746
1431,111,1990,16,2,3,0,736,287,2.56446,13,-23,481,40.3,194,736
1432,111,1991,14,1,3,0,711,285,2.494737,11,-36,483,41,198,711
1433,111,1992,9,4,3,0,574,228,2.517544,6,-142,484,52.9,256,574
1434,111,1993,6,7,5,0,540,202,2.673267,1,-31,488,58.6,286,540
1435,111,1994,7,2,0,0,563,209,2.69378,7,14,495,57.8,286,563
1436,111,1995,10,6,6,0,571,211,2.706161,4,4,497,57.5,286,571
1437,111,1996,6,6,4,0,579,215,2.693023,2,6,503,57.3,288,579
1438,111,1997,5,10,7,0,570,214,2.663551,-2,-9,509,58,295,570
1439,111,1998,5,7,3,0,555,207,2.681159,2,-18,519,60.1,312,555
1440,111,1999,8,4,5,0,557,206,2.703883,3,-1,606,66,400,557
1441,111,2000,3,1,3,5,556,270,2.059259259,0,9,633,57.34597156,363,561
1442,111,2001,5,5,3,5,561,273,2.054945055,2,3,639,57.27699531,366,566
1443,111,2002,5,9,1,5,594,290,2.048275862,4,29,650,55.38461538,360,599
1444,111,2003,6,14,0,5,610,298,2.046979866,6,10,664,55.12048193,366,615
1445,111,2004,6,19,3,5,630,308,2.045454545,3,17,685,55.03649635,377,635
1446,111,2005,6,19,3,5,640,314,2.038216561,3,7,706,55.52407932,392,645
1447,111,2006,9,20,2,5,667,327,2.039755352,7,20,729,55.14403292,402,672
1448,111,2007,7,11,4,5,681,335,2.032835821,3,11,741,54.79082321,406,686
1449,111,2008,5,4,2,5,693,341,2.032258065,3,9,746,54.28954424,405,698
1450,111,2009,3,7,3,5,682,335,2.035820896,0,-11,752,55.45212766,417,687
1451,113,1985,63,156,5,0,3189,1415,2.25371,58,172,2103,32.7,688,3189
1452,113,1986,52,78,12,0,3374,1546,2.182406,40,145,2265,31.7,719,3374
1453,113,1987,47,43,8,0,3463,1619,2.138975,39,50,2350,31.1,731,3463
1454,113,1988,63,56,14,0,3557,1700,2.092353,49,45,2395,29,695,3557
1455,113,1989,43,92,8,0,3612,1769,2.041831,35,20,2440,27.5,671,3612
1456,113,1990,57,136,11,56,3676,1489,2.468771,46,74,2635,43.5,1146,3732
1457,113,1991,53,178,10,57,4073,1546,2.634541,43,355,2771,44.2,1225,4130
1458,113,1992,49,169,11,53,4512,1489,3.030222,38,397,2949,49.5,1460,4565
1459,113,1993,51,220,19,65,4799,1920,2.499479,32,267,3123,38.5,1203,4864
1460,113,1994,48,353,8,78,5227,2076,2.517823,40,401,3343,37.9,1267,5305
1461,113,1995,63,113,11,75,5414,2132,2.5394,52,132,3696,42.3,1564,5489
1462,113,1996,64,152,15,78,5726,2239,2.557392,49,266,3809,41.2,1570,5804
1463,113,1997,53,114,14,79,5874,2294,2.560593,39,110,3961,42.1,1667,5953
1464,113,1998,74,178,10,79,6374,2350,2.71234,64,436,4075,42.3,1725,6453
1465,113,1999,56,145,10,79,6454,2476,2.606624,46,34,4530,45.3,2054,6533
1466,113,2000,67,35,13,17,6598,3027,2.17971589,54,30,5231,42.13343529,2204,6615
1467,113,2001,65,138,15,17,6883,3169,2.171978542,50,235,5392,41.22774481,2223,6900
1468,113,2002,84,130,13,17,7025,3243,2.166204132,71,71,5555,41.62016202,2312,7042
1469,113,2003,74,97,24,17,6993,3234,2.162337662,50,-82,5690,43.16344464,2456,7010
1470,113,2004,78,94,15,17,7010,3248,2.158251232,63,-46,5813,44.12523654,2565,7027
1471,113,2005,72,126,15,17,7028,3258,2.157151627,57,-39,5930,45.05902192,2672,7045
1472,113,2006,105,205,21,17,7042,3273,2.151542927,84,-70,6157,46.84099399,2884,7059
1473,113,2007,96,155,19,17,7259,3397,2.136885487,77,140,6343,46.44489989,2946,7276
1474,113,2008,118,148,11,17,7287,3416,2.133196721,107,-79,6521,47.61539641,3105,7304
1475,113,2009,79,120,13,17,7250,3399,2.132980288,66,-103,6583,48.36700592,3184,7267
1476,115,1985,30,0,39,50,2941,1240,2.371774,-9,-201,1519,18.4,279,2991
1477,115,1986,36,0,27,47,2778,1190,2.334454,9,-175,1520,21.7,330,2825
1478,115,1987,31,0,38,47,2746,1195,2.297908,-7,-25,1520,21.4,325,2793
1479,115,1988,35,0,30,47,2747,1213,2.264633,5,-4,1521,20.2,308,2794
1480,115,1989,28,2,39,47,2687,1206,2.228027,-11,-49,1524,20.9,318,2734
1481,115,1990,29,2,22,32,2648,1141,2.320771,7,-61,1414,19.3,273,2680
1482,115,1991,30,2,22,31,2639,1115,2.366816,8,-18,1416,21.3,301,2670
1483,115,1992,30,1,41,31,2598,1115,2.330045,-11,-30,1418,21.4,303,2629
1484,115,1993,19,2,34,31,2618,1122,2.333333,-15,35,1419,20.9,297,2649
1485,115,1994,31,1,47,31,2633,1121,2.348796,-16,31,1421,21.1,300,2664
1486,115,1995,34,0,42,31,2619,1116,2.346774,-8,-6,1422,21.5,306,2650
1487,115,1996,29,2,43,31,2655,1136,2.337148,-14,50,1422,20.1,286,2686
1488,115,1997,29,21,38,31,2700,1163,2.321582,-9,54,1424,18.3,261,2731
1489,115,1998,35,9,47,31,2650,1142,2.32049,-12,-38,1445,21,303,2681
1490,115,1999,35,2,35,31,2688,1158,2.321244,0,38,1454,20.4,296,2719
1491,115,2000,30,1,42,57,2687,1166,2.304459691,-12,38,1389,16.05471562,223,2744
1492,115,2001,33,4,37,57,2637,1152,2.2890625,-4,-46,1396,17.47851003,244,2694
1493,115,2002,30,2,43,57,2637,1161,2.271317829,-13,13,1401,17.13062099,240,2694
1494,115,2003,20,0,39,57,2658,1179,2.254452926,-19,40,1402,15.90584879,223,2715
1495,115,2004,31,1,44,57,2549,1132,2.251766784,-13,-96,1389,18.5025198,257,2606
1496,115,2005,35,2,49,57,2521,1132,2.227031802,-14,-14,1394,18.79483501,262,2578
1497,115,2006,21,2,34,57,2458,1113,2.208445642,-13,-50,1399,20.4431737,286,2515
1498,115,2007,14,1,34,57,2365,1081,2.187789084,-20,-73,1403,22.95081967,322,2422
1499,115,2008,27,1,33,57,2363,1092,2.163919414,-6,4,1408,22.44318182,316,2420
1500,115,2009,21,1,31,57,2319,1080,2.147222222,-10,-34,1411,23.45854004,331,2376
1501,117,1985,243,115,25,0,12865,5697,2.258206,218,633,14623,61,8926,12865
1502,117,1986,236,183,17,0,13274,5978,2.220475,219,190,14708,59.4,8730,13274
1503,117,1987,188,94,16,0,12406,5693,2.179168,172,-1040,14862,61.7,9169,12406
1504,117,1988,203,113,22,0,12498,5849,2.136775,181,-89,14960,60.9,9111,12498
1505,117,1989,196,150,20,0,12718,6090,2.088341,176,44,15115,59.7,9025,12718
1506,117,1990,207,244,9,55,12885,5295,2.433428,198,24,17091,69,11796,12940
1507,117,1991,209,198,13,55,13416,5448,2.462555,196,335,17335,68.6,11887,13471
1508,117,1992,202,298,31,59,13781,5684,2.424525,171,198,17533,67.6,11849,13840
1509,117,1993,203,444,38,62,15132,6014,2.516129,165,1189,17831,66.3,11817,15194
1510,117,1994,211,862,20,69,17038,6678,2.551363,191,1722,18275,63.5,11597,17107
1511,117,1995,200,947,20,71,18199,7055,2.579589,180,983,19500,63.8,12445,18270
1512,117,1996,194,1270,36,75,19321,7429,2.600754,158,968,20447,63.7,13018,19396
1513,117,1997,241,927,39,77,20272,7777,2.606661,202,751,21224,63.4,13447,20349
1514,117,1998,216,1162,30,77,21204,8049,2.634365,186,746,22211,63.8,14162,21281
1515,117,1999,281,488,46,77,22491,8397,2.678457,235,1052,23807,64.7,15410,22568
1516,117,2000,275,194,38,927,24782,10169,2.437014456,237,2904,27457,62.9639072,17288,25709
1517,117,2001,329,777,44,927,25366,10408,2.43716372,285,299,28741,63.7869246,18333,26293
1518,117,2002,364,464,41,927,25587,10505,2.435697287,323,-102,28911,63.66434921,18406,26514
1519,117,2003,346,384,32,927,25779,10588,2.434737439,314,-122,29154,63.68251355,18566,26706
1520,117,2004,353,397,46,927,25780,10593,2.433682621,307,-306,29282,63.82419234,18689,26707
1521,117,2005,339,322,46,927,25696,10568,2.431491294,293,-377,29379,64.028728,18811,26623
1522,117,2006,367,456,50,927,25912,10660,2.430769231,317,-101,29419,63.76491383,18759,26839
1523,117,2007,345,422,42,927,26236,10801,2.429034349,303,21,29536,63.43106717,18735,27163
1524,117,2008,366,437,49,927,26537,10928,2.428349195,317,-16,29646,63.13836605,18718,27464
1525,117,2009,373,341,47,927,26856,11072,2.425578035,326,-7,29943,63.02307718,18871,27783
1526,119,1985,202,116,62,52,11253,3920,2.870663,140,313,6844,42.7,2924,11305
1527,119,1986,209,242,58,52,11748,4079,2.880118,151,344,7014,41.8,2935,11800
1528,119,1987,191,170,57,52,12406,4284,2.895892,134,524,7309,41.4,3025,12458
1529,119,1988,179,82,52,50,12427,4267,2.912351,127,-108,7488,43,3221,12477
1530,119,1989,190,78,53,49,12425,4248,2.924906,137,-140,7503,43.4,3255,12474
1531,119,1990,185,68,61,64,12447,4720,2.637076,124,-87,7565,37.6,2845,12511
1532,119,1991,194,74,73,66,12646,4996,2.531225,121,80,7633,34.5,2637,12712
1533,119,1992,155,189,65,67,13603,5076,2.679866,90,868,7707,34.1,2631,13670
1534,119,1993,143,198,66,77,14658,5680,2.580634,77,988,7896,28.1,2216,14735
1535,119,1994,185,249,73,82,15708,6118,2.567506,112,943,8094,24.4,1976,15790
1536,119,1995,214,264,78,99,16882,6615,2.552079,136,1055,8343,20.7,1728,16981
1537,119,1996,220,533,93,106,18029,7035,2.562758,127,1027,8607,18.3,1572,18135
1538,119,1997,236,368,65,128,18938,7498,2.52574,171,760,9189,18.4,1691,19066
1539,119,1998,203,301,82,128,19544,7777,2.513051,121,485,9557,18.6,1780,19672
1540,119,1999,218,304,73,128,20051,8024,2.498878,145,362,9858,18.6,1834,20179
1541,119,2000,214,90,96,120,20948,8207,2.552455221,118,766,10660,23.01125704,2453,21068
1542,119,2001,211,359,83,120,21618,8532,2.533755274,128,542,11043,22.73838631,2511,21738
1543,119,2002,249,203,96,120,21869,8694,2.515412928,153,98,11285,22.95968099,2591,21989
1544,119,2003,232,229,93,120,22098,8853,2.496103016,139,90,11532,23.23100937,2679,22218
1545,119,2004,219,206,95,120,22098,8918,2.477909845,124,-124,11778,24.28256071,2860,22218
1546,119,2005,205,275,104,120,22385,9101,2.459619822,101,186,12104,24.80998017,3003,22505
1547,119,2006,206,195,120,120,22671,9292,2.439840723,86,200,12294,24.41841549,3002,22791
1548,119,2007,234,160,98,120,23044,9519,2.420842525,136,237,12450,23.54216867,2931,23164
1549,119,2008,195,137,121,120,22982,9570,2.401462905,74,-136,12583,23.94500517,3013,23102
1550,119,2009,183,88,124,120,23085,9690,2.382352941,59,44,12619,23.21103099,2929,23205
1551,121,1985,68,3,61,23,5373,2108,2.548862,7,-155,2555,17.5,447,5396
1552,121,1986,77,2,52,22,5172,2043,2.531571,25,-227,2570,20.5,527,5194
1553,121,1987,75,4,54,22,5165,2050,2.519512,21,-28,2584,20.7,534,5187
1554,121,1988,52,1,46,22,5120,2042,2.507346,6,-51,2591,21.2,549,5142
1555,121,1989,53,2,42,21,4930,1977,2.493677,11,-202,2630,24.8,653,4951
1556,121,1990,58,3,56,34,4770,1915,2.490862,2,-149,2307,17,392,4804
1557,121,1991,45,4,69,37,4746,2122,2.236569,-24,3,2310,8.1,188,4783
1558,121,1992,63,2,52,38,4848,2143,2.262249,11,92,2314,7.4,171,4886
1559,121,1993,56,3,52,37,5107,2073,2.463579,4,254,2316,10.5,243,5144
1560,121,1994,60,1,52,37,5184,2107,2.46037,8,69,2319,9.1,212,5221
1561,121,1995,70,12,55,38,5198,2125,2.446118,15,0,2320,8.4,195,5236
1562,121,1996,49,9,58,38,5183,2136,2.426498,-9,-6,2332,8.4,196,5221
1563,121,1997,61,11,52,38,5172,2157,2.397775,9,-20,2341,7.9,184,5210
1564,121,1998,45,17,59,38,5117,2145,2.385548,-14,-41,2352,8.8,207,5155
1565,121,1999,65,8,62,38,4986,2100,2.374286,3,-134,2369,11.4,269,5024
1566,121,2000,46,4,53,39,4897,1995,2.454636591,-7,-79,2312,13.71107266,317,4936
1567,121,2001,48,16,43,52,4847,1984,2.443044355,5,-42,2332,14.92281304,348,4899
1568,121,2002,40,10,65,161,5098,2097,2.431092036,-25,385,2345,10.57569296,248,5259
1569,121,2003,57,15,49,161,4979,2058,2.419339164,8,-127,2364,12.94416244,306,5140
1570,121,2004,38,11,57,222,4838,2010,2.406965174,-19,-61,2379,15.51071879,369,5060
1571,121,2005,45,4,47,222,4773,1992,2.396084337,-2,-63,2386,16.51299246,394,4995
1572,121,2006,45,6,57,222,4759,1998,2.381881882,-12,-2,2394,16.54135338,396,4981
1573,121,2007,42,9,38,222,4705,1984,2.371471774,4,-58,2407,17.57374325,423,4927
1574,121,2008,43,7,53,222,4580,1941,2.359608449,-10,-115,2418,19.72704715,477,4802
1575,121,2009,44,1,44,222,4555,1940,2.347938144,0,-25,2427,20.06592501,487,4777
1576,123,1985,2262,878,830,4514,125886,48812,2.578997,1432,-21,50425,3.2,1613,130400
1577,123,1986,2159,668,840,4562,125187,49446,2.531792,1319,-1970,51309,3.6,1863,129749
1578,123,1987,2143,413,874,4688,126340,50388,2.507343,1269,10,51988,3.1,1600,131028
1579,123,1988,2120,295,806,4406,127474,51212,2.489143,1314,-462,52466,2.4,1254,131880
1580,123,1989,2164,253,841,4526,127341,51760,2.46022,1323,-1336,52759,1.9,999,131867
1581,123,1990,2202,262,843,4160,127786,47470,2.691932,1359,-1280,51138,7.2,3668,131946
1582,123,1991,2270,355,834,4301,131430,48760,2.695447,1436,2349,51400,5.1,2640,135731
1583,123,1992,2298,506,899,4295,135827,49801,2.727395,1399,2992,51756,3.8,1955,140122
1584,123,1993,2322,956,955,4452,141326,50639,2.790853,1367,4289,52262,3.1,1623,145778
1585,123,1994,2326,1158,945,4615,146753,51903,2.827447,1381,4209,53274,2.6,1371,151368
1586,123,1995,2224,1469,926,4556,152617,53305,2.86309,1298,4507,54432,2.1,1127,157173
1587,123,1996,2309,1854,1067,4699,157110,54788,2.867599,1242,3394,55929,2,1141,161809
1588,123,1997,2487,2114,1005,4729,162111,56803,2.853916,1482,3549,57764,1.7,961,166840
1589,123,1998,2599,3063,1062,4886,167508,58273,2.874539,1537,4017,59950,2.8,1677,172394
1590,123,1999,2841,3552,1096,5043,172222,63087,2.729913,1745,3126,65316,3.4,2229,177265
1591,123,2000,2998,1007,1053,4977,178099,64025,2.781710269,1945,3864,67366,4.959475106,3341,183076
1592,123,2001,3245,4029,1210,5031,187451,67408,2.780842037,2035,7371,71809,6.128758234,4401,192482
1593,123,2002,3447,4115,1178,5050,193925,69750,2.780286738,2269,4224,76236,8.507791595,6486,198975
1594,123,2003,3651,4113,1224,5048,202109,72733,2.778779921,2427,5755,80488,9.634976642,7755,207157
1595,123,2004,3895,3562,1217,5037,209032,75257,2.777575508,2678,4234,84557,10.99849805,9300,214069
1596,123,2005,3849,3768,1263,5065,218367,78672,2.775663514,2586,6777,88602,11.20742195,9930,223432
1597,123,2006,4001,3691,1259,5077,226206,81597,2.772234273,2742,5109,92059,11.36445106,10462,231283
1598,123,2007,4101,2433,1314,5060,233219,84195,2.769986341,2787,4209,94523,10.92644118,10328,238279
1599,123,2008,4013,1596,1294,5051,239065,86395,2.767116153,2719,3118,95692,9.715545709,9297,244116
1600,123,2009,3923,837,1314,5057,243902,88253,2.763668091,2609,2234,96177,8.238976055,7924,248959
1601,125,1985,145,1,95,136,9717,3840,2.530469,50,-132,4343,11.6,503,9853
1602,125,1986,145,3,104,132,9451,3768,2.508227,41,-311,4339,13.2,571,9583
1603,125,1987,125,1,100,131,9303,3740,2.487433,25,-174,4336,13.7,596,9434
1604,125,1988,111,1,115,133,9431,3824,2.466266,-4,134,4343,12,519,9564
1605,125,1989,92,1,98,129,9082,3719,2.442054,-6,-347,4300,13.5,581,9211
1606,125,1990,139,1,93,121,8826,3472,2.542051,46,-310,4082,14.9,610,8947
1607,125,1991,128,1,91,121,8890,3494,2.544362,37,27,4083,14.4,589,9011
1608,125,1992,113,3,93,119,8882,3430,2.589504,20,-30,4084,16,654,9001
1609,125,1993,107,8,96,124,9042,3551,2.546325,11,154,4092,13.2,541,9166
1610,125,1994,98,8,83,124,9152,3596,2.54505,15,95,4100,12.3,504,9276
1611,125,1995,95,13,105,127,9328,3664,2.545851,-10,189,4108,10.8,444,9455
1612,125,1996,108,19,106,128,9393,3698,2.540022,2,64,4121,10.3,423,9521
1613,125,1997,128,10,114,130,9527,3780,2.52037,14,122,4140,8.7,360,9657
1614,125,1998,139,7,103,130,9669,3810,2.537795,36,106,4150,8.2,340,9799
1615,125,1999,141,14,99,130,9693,3844,2.521592,42,-18,4250,9.6,406,9823
1616,125,2000,92,4,91,135,9680,3791,2.553415985,1,-4,4301,11.85770751,510,9815
1617,125,2001,144,17,114,146,9685,3802,2.547343503,30,-14,4329,12.17371217,527,9831
1618,125,2002,119,11,115,210,9737,3834,2.539645279,4,112,4353,11.92281185,519,9947
1619,125,2003,163,8,107,209,9884,3903,2.532410966,56,90,4372,10.7273559,469,10093
1620,125,2004,140,9,104,207,9678,3830,2.52689295,36,-244,4392,12.79599271,562,9885
1621,125,2005,142,2,105,205,9687,3843,2.520686963,37,-30,4406,12.77802996,563,9892
1622,125,2006,153,1,112,216,9701,3857,2.515167228,41,-16,4417,12.67828843,560,9917
1623,125,2007,148,5,89,221,9660,3850,2.509090909,59,-95,4435,13.19052988,585,9881
1624,125,2008,159,0,121,219,9676,3866,2.502845318,38,-24,4446,13.0454341,580,9895
1625,125,2009,166,4,90,217,9819,3934,2.495932893,76,65,4457,11.73435046,523,10036
1626,0,2010,67306,2338.74,31396,116927,4933405,1981000,2.49,35910,37569,2215332,10.58,234332,5050332
1627,1,2010,7436,130.91,2474,4027,439684,154502,2.84,4962,2426,163259,5.36,8757,443711
1628,3,2010,250,7.50,127,740,14734,6008,2.45,123,50,6561,8.42,553,15474
1629,5,2010,7981,278.37,3295,4920,569899,225124,2.53,4686,3653,238566,5.63,13442,574819
1630,7,2010,108,10.50,63,129,11931,5257,2.26,45,116,8772,40.07,3515,12060
1631,9,2010,39,0.25,52,82,3713,1687,2.20,-13,-6,2248,24.95,561,3795
1632,11,2010,54,0.75,58,2208,4298,1835,2.34,-4,29,2243,18.18,408,6506
1633,13,2010,3141,97.48,1544,9396,286209,119574,2.39,1597,367,127183,5.98,7609,295605
1634,14,2010,690,40.00,271,282,55825,21498,2.59,419,310,22684,5.22,1186,56107
1635,15,2010,138,22.75,157,1436,16361,7596,2.15,-19,212,10043,24.36,2447,17797
1636,17,2010,21,0.00,18,42,1792,786,2.27,3,-2,975,19.38,189,1834
1637,19,2010,81,2.00,64,131,9024,4217,2.13,17,78,5687,25.84,1470,9155
1638,21,2010,137,4.25,73,36,8246,3128,2.63,64,8,4290,27.08,1162,8282
1639,23,2010,27,8.50,28,0,3532,1554,2.27,-1,28,2622,40.73,1068,3532
1640,25,2010,37,0.25,32,2682,3156,1311,2.40,5,30,1559,15.90,248,5838
1641,27,2010,25,15.00,37,150,4122,1933,2.13,-12,118,3971,51.32,2038,4272
1642,29,2010,341,3.25,339,713,30176,12678,2.38,2,262,14575,13.01,1897,30889
1643,31,2010,9716,222.00,4229,15981,588898,265233,2.22,5487,3819,286635,7.46,21402,604879
1644,33,2010,17,0.25,14,0,2060,898,2.29,3,5,1468,38.82,570,2060
1645,35,2010,3627,212.85,904,800,286324,102564,2.79,2723,2238,107071,4.20,4507,287124
1646,37,2010,775,19.16,96,55,52002,19184,2.71,679,-142,31330,38.76,12146,52057
1647,39,2010,163,9.75,107,73,23034,8388,2.74,56,161,8949,6.26,561,23107
1648,41,2010,9002,333.21,3526,19141,608091,237926,2.55,5476,13238,252957,5.94,15031,627232
1649,43,2010,373,11.50,504,8704,38150,16595,2.29,-131,350,19256,13.81,2661,46854
1650,45,2010,912,19.50,278,884,55266,20272,2.72,634,116,23327,13.09,3055,56150
1651,47,2010,47,4.00,25,49,5414,2471,2.19,22,45,3564,30.66,1093,5463
1652,49,2010,138,35.00,44,222,14568,6444,2.26,94,32,16094,59.96,9650,14790
1653,51,2010,158,21.75,69,850,14459,6510,2.22,89,-46,11434,43.06,4924,15309
1654,53,2010,10,2.25,4,56,787,362,2.17,6,10,1391,73.97,1029,843
1655,55,2010,56,8.75,102,165,6490,3110,2.08,-46,-9,5084,38.82,1974,6655
1656,57,2010,10,1.75,7,2,1385,646,2.14,3,-2,1288,49.84,642,1387
1657,59,2010,5723,101.53,3757,7427,528224,218625,2.41,1966,1079,230166,5.01,11541,535651
1658,61,2010,6,1.25,19,14,1385,619,2.23,-13,20,806,23.20,187,1399
1659,63,2010,108,0.25,81,1075,7192,3037,2.36,27,-29,3527,13.89,490,8267
1660,65,2010,106,0.00,36,133,7149,2941,2.43,70,38,4271,31.14,1330,7282
1661,67,2010,589,58.25,270,1715,49726,21144,2.35,319,363,25917,18.41,4773,51441
1662,69,2010,3378,120.17,1818,8530,292002,120677,2.41,1560,1470,132836,9.15,12159,300532
1663,71,2010,154,4.50,176,858,14549,6341,2.29,-22,-48,8221,22.86,1880,15407
1664,73,2010,57,1.75,48,1030,4444,1951,2.27,9,2,2422,19.44,471,5474
1665,75,2010,206,3.75,202,3474,18819,8053,2.33,4,-228,8985,10.37,932,22293
1666,77,2010,2021,91.25,1309,4467,142688,57963,2.46,712,1648,62358,7.04,4395,147155
1667,79,2010,9,1.75,8,0,705,351,2.00,1,-10,1203,70.82,852,705
1668,81,2010,217,5.25,103,102,13704,5470,2.50,114,148,6202,11.80,732,13806
1669,83,2010,317,4.00,270,237,25295,10540,2.39,47,120,12098,12.87,1558,25532
1670,85,2010,487,29.50,389,542,40646,16449,2.47,98,410,18280,10.01,1831,41188
1671,87,2010,447,4.75,239,564,27632,10308,2.68,208,-38,11495,10.32,1187,28196
1672,89,2010,218,0.75,213,433,18405,7732,2.38,5,-11,8970,13.80,1238,18838
1673,91,2010,38,5.25,27,0,4446,2026,2.19,11,63,3088,34.39,1062,4446
1674,93,2010,121,26.50,82,92,16170,7199,2.24,39,252,13973,48.47,6774,16262
1675,95,2010,59,1.75,54,60,4405,1829,2.40,5,6,2089,12.44,260,4465
1676,97,2010,141,7.09,38,72,17084,8156,2.09,103,0,12960,37.06,4804,17156
1677,99,2010,186,0.25,123,315,12216,4928,2.47,63,-108,5942,17.06,1014,12531
1678,101,2010,2070,94.25,1542,4321,155175,63148,2.45,528,1644,69615,9.28,6467,159496
1679,103,2010,101,6.50,43,235,6382,2626,2.43,58,242,3315,20.78,689,6617
1680,105,2010,166,3.50,125,198,11803,4787,2.46,41,-35,6633,27.83,1846,12001
1681,107,2010,247,17.50,90,335,23104,9863,2.34,157,-43,16321,39.56,6458,23439
1682,109,2010,65,9.75,47,18,6126,2652,2.30,18,0,3854,31.18,1202,6144
1683,111,2010,3,1.00,3,0,709,349,2.03,0,22,757,53.89,408,709
1684,113,2010,65,11.00,20,9,7347,3451,2.12,45,44,6659,48.17,3208,7356
1685,115,2010,21,0.25,36,35,2332,1087,2.14,-15,6,1415,23.18,328,2367
1686,117,2010,287,19.50,51,273,27800,11787,2.35,236,54,29861,60.52,18074,28073
1687,119,2010,202,9.04,151,132,23309,9844,2.36,51,185,12651,22.18,2807,23441
1688,121,2010,54,1.75,41,184,4631,1980,2.33,13,25,2436,18.71,456,4815
1689,123,2010,3799,171.68,1352,5895,248335,89849,2.76,2447,2824,96454,6.84,6605,254230
1690,125,2010,128,0.00,92,196,9836,3947,2.49,36,-40,4466,11.62,519,10032
1691,0,2011,65923,13657.00,32017,118691,5000847,2007940,2.49,33906,33536,2225481,9.78,217542,5119538
1692,1,2011,7244,671.00,2462,4028,447721,157300,2.85,4782,3255,163875,4.01,6575,451749
1693,3,2011,234,38.00,131,740,14939,6090,2.45,103,102,6600,7.73,510,15679
1694,5,2011,7721,1254.00,3426,4795,580712,229419,2.53,4295,6518,239195,4.09,9776,585507
1695,7,2011,137,37.00,82,129,11874,5232,2.27,55,-112,8818,40.67,3586,12003
1696,9,2011,41,2.00,73,82,3717,1690,2.20,-32,36,2250,24.89,560,3799
1697,11,2011,44,0.00,60,2114,4190,1789,2.34,-16,-92,2243,20.24,454,6304
1698,13,2011,2994,710.00,1511,10003,290168,121242,2.39,1483,2476,127873,5.19,6632,300171
1699,14,2011,701,232.00,322,282,56929,21923,2.60,379,725,22894,4.24,971,57211
1700,15,2011,147,101.00,157,1492,16520,7668,2.15,-10,169,10129,24.30,2461,18012
1701,17,2011,21,1.00,21,42,1822,799,2.28,0,30,976,18.14,177,1864
1702,19,2011,70,13.00,58,90,8980,4198,2.14,12,-56,5700,26.35,1502,9070
1703,21,2011,104,17.00,88,36,8246,3128,2.64,16,-16,4307,27.37,1179,8282
1704,23,2011,37,24.00,32,0,3647,1605,2.27,5,110,2649,39.41,1044,3647
1705,25,2011,34,4.00,36,2638,3179,1322,2.40,-2,25,1563,15.42,241,5817
1706,27,2011,22,67.00,29,150,4077,1912,2.13,-7,-38,4034,52.60,2122,4227
1707,29,2011,344,10.00,356,680,29690,12472,2.38,-12,-474,14567,14.38,2095,30370
1708,31,2011,9622,1232.00,4184,16220,604464,272244,2.22,5438,10128,287753,5.39,15509,620684
1709,33,2011,18,0.00,17,0,2025,882,2.30,1,-36,1468,39.92,586,2025
1710,35,2011,3557,2490.00,905,772,291706,104489,2.79,2652,2730,107869,3.13,3380,292478
1711,37,2011,650,56.00,83,70,51579,19025,2.71,567,-990,31382,39.38,12357,51649
1712,39,2011,174,33.00,108,19975,618314,241890,2.56,66,40,253871,4.72,11981,23213
1713,41,2011,9231,2321.00,3650,73,23140,8425,2.75,5581,4642,8981,6.19,556,638289
1714,43,2011,379,53.00,528,9053,38353,16682,2.30,-149,352,19313,13.62,2631,47406
1715,45,2011,863,37.00,294,868,55137,20224,2.73,569,-698,23363,13.44,3139,56005
1716,47,2011,47,4.00,28,49,5399,2463,2.19,19,-34,3568,30.97,1105,5448
1717,49,2011,106,87.00,66,222,14326,6338,2.26,40,-282,16181,60.83,9843,14548
1718,51,2011,152,73.00,58,721,14548,6549,2.22,94,-5,11505,43.08,4956,15269
1719,53,2011,5,7.00,7,56,768,353,2.18,-2,-17,1398,74.75,1045,824
1720,55,2011,46,30.00,105,165,6339,3037,2.09,-59,-92,5119,40.67,2082,6504
1721,57,2011,12,7.00,10,2,1370,639,2.14,2,-17,1295,50.66,656,1372
1722,59,2011,5529,603.00,3738,7722,531999,220186,2.42,1791,1984,230724,4.57,10538,539721
1723,61,2011,20,6.00,22,14,1431,640,2.24,-2,48,813,21.28,173,1445
1724,63,2011,105,2.00,83,874,7307,3084,2.37,22,93,3529,12.61,445,8181
1725,65,2011,104,19.00,41,1715,50151,21323,2.35,63,29,26132,18.40,4809,7382
1726,67,2011,543,222.00,246,141,7241,2978,2.43,297,128,4290,30.58,1312,51866
1727,69,2011,3313,1187.00,1861,8376,296702,122593,2.42,1452,3248,134051,8.55,11458,305078
1728,71,2011,149,20.00,196,861,14184,6181,2.29,-47,-318,8230,24.90,2049,15045
1729,73,2011,64,1.00,52,971,4426,1944,2.28,12,-30,2423,19.77,479,5397
1730,75,2011,212,15.00,182,3535,18719,8009,2.34,30,-130,9000,11.01,991,22254
1731,77,2011,1908,364.00,1296,4791,143317,58255,2.46,612,17,63183,7.80,4928,148108
1732,79,2011,5,5.00,3,0,706,352,2.01,2,-1,1212,70.96,860,706
1733,81,2011,187,7.00,67,102,13300,5308,2.51,120,-524,6209,14.51,901,13402
1734,83,2011,308,11.00,288,237,25226,10511,2.40,20,-89,12109,13.20,1598,25463
1735,85,2011,492,62.00,399,542,40352,16330,2.47,93,-387,18353,11.02,2023,40894
1736,87,2011,460,2.00,277,564,27870,10396,2.68,183,55,11503,9.62,1107,28434
1737,89,2011,245,3.00,216,433,18398,7729,2.38,29,-36,8973,13.86,1244,18831
1738,91,2011,29,20.00,19,0,4422,2016,2.19,10,-34,3104,35.05,1088,4422
1739,93,2011,117,95.00,83,92,16004,7125,2.25,34,-200,14065,49.34,6940,16096
1740,95,2011,51,3.00,61,60,4313,1791,2.41,-10,-82,2092,14.39,301,4373
1741,97,2011,175,44.00,53,72,17053,8139,2.10,122,-153,12994,37.36,4855,17125
1742,99,2011,142,2.00,149,315,12152,4903,2.48,-7,-57,5945,17.53,1042,12467
1743,101,2011,1865,291.00,1651,4327,155830,63410,2.46,214,441,69872,9.25,6462,160157
1744,103,2011,106,21.00,40,145,6551,2697,2.43,66,103,3323,18.84,626,6696
1745,105,2011,143,18.00,122,198,11707,4747,2.47,21,-117,6651,28.63,1904,11905
1746,107,2011,228,27.00,88,338,22899,9774,2.34,140,-345,16349,40.22,6575,23237
1747,109,2011,79,35.00,37,18,6166,2675,2.31,42,-2,3890,31.23,1215,6184
1748,111,2011,8,1.00,8,0,693,341,2.03,0,-16,758,55.01,417,693
1749,113,2011,76,25.00,18,9,7468,3507,2.13,58,63,6683,47.52,3176,7477
1750,115,2011,29,0.00,41,35,2332,1087,2.15,-12,12,1415,23.18,328,2367
1751,117,2011,308,117.00,54,273,27681,11736,2.36,254,-373,30024,60.91,18288,27954
1752,119,2011,222,30.00,134,132,23162,9781,2.37,88,-235,12668,22.79,2887,23294
1753,121,2011,40,5.00,53,184,4605,1969,2.34,-13,-13,2441,19.34,472,4789
1754,123,2011,3749,778.00,1434,5872,252679,91412,2.76,2315,2029,97263,6.02,5851,258551
1755,125,2011,155,5.00,118,196,9922,3982,2.49,37,49,4471,10.94,489,10118
1756,0,2012,64733,14278.00,32763,117928,5073158,2036694,2.49,31970,40341,2236805,8.95,200110,5191086
1757,1,2012,6923,714.00,2750,4014,456050,160214,2.85,4173,4156,164378,2.53,4164,460064
1758,3,2012,208,53.00,118,740,14947,6094,2.45,90,-82,6619,7.93,525,15687
1759,5,2012,7754,334.00,3380,4764,591012,233477,2.53,4374,5926,239524,2.52,6047,595776
1760,7,2012,116,36.00,72,129,11980,5278,2.27,44,62,8870,40.50,3592,12109
1761,9,2012,53,2.00,72,82,3664,1666,2.20,-19,-34,2252,26.02,586,3746
1762,11,2012,55,1.00,60,1686,4092,1747,2.34,-5,-93,2245,22.18,498,5778
1763,13,2012,2953,713.00,1570,10002,295014,123243,2.39,1383,3463,128436,4.04,5192,305016
1764,14,2012,684,229.00,330,282,58433,22502,2.60,354,1150,23103,2.60,601,58715
1765,15,2012,152,69.00,157,1489,16634,7720,2.15,-5,119,10173,24.11,2453,18123
1766,17,2012,38,0.00,27,42,1833,804,2.28,11,0,976,17.62,172,1875
1767,19,2012,63,16.00,46,107,8996,4205,2.14,17,-1,5716,26.43,1511,9103
1768,21,2012,126,13.00,82,36,8210,3114,2.64,44,-80,4321,27.93,1207,8246
1769,23,2012,29,22.00,41,0,3601,1584,2.27,-12,-34,2667,40.61,1083,3601
1770,25,2012,40,2.00,47,2291,3085,1282,2.41,-7,-87,1565,18.08,283,5376
1771,27,2012,26,66.00,36,150,4091,1918,2.13,-10,24,4099,53.21,2181,4241
1772,29,2012,337,50.00,315,723,29738,12493,2.38,22,26,14555,14.17,2062,30461
1773,31,2012,9181,2685.00,4173,16214,618257,278456,2.22,5008,8785,289832,3.93,11376,634471
1774,33,2012,24,0.00,17,0,1990,866,2.30,7,-42,1468,41.01,602,1990
1775,35,2012,3477,1990.00,1034,775,297863,106700,2.79,2443,3714,108865,1.99,2165,298638
1776,37,2012,695,51.00,100,70,51779,19098,2.71,595,-395,31433,39.24,12335,51849
1777,39,2012,171,30.00,116,19997,627449,245442,2.56,55,103,256167,4.19,10725,23371
1778,41,2012,9156,2706.00,3781,73,23298,8483,2.75,5375,3760,9010,5.85,527,647446
1779,43,2012,388,46.00,498,8666,38409,16707,2.30,-110,166,19372,13.76,2665,47075
1780,45,2012,788,33.00,252,884,55886,20498,2.73,536,213,23395,12.38,2897,56770
1781,47,2012,39,16.00,27,49,5408,2468,2.19,12,-3,3584,31.14,1116,5457
1782,49,2012,111,59.00,45,222,13935,6186,2.25,66,-457,15612,60.38,9426,14157
1783,51,2012,164,50.00,74,824,14560,6555,2.22,90,-78,11554,43.27,4999,15384
1784,53,2012,6,6.00,3,56,739,340,2.17,3,-32,1404,75.78,1064,795
1785,55,2012,59,30.00,106,165,6398,3067,2.09,-47,106,5144,40.38,2077,6563
1786,57,2012,9,2.00,15,2,1336,623,2.14,-6,-28,1297,51.97,674,1338
1787,59,2012,5556,976.00,3897,7729,538151,222732,2.42,1659,4493,231657,3.85,8925,545880
1788,61,2012,8,1.00,21,14,1411,630,2.24,-13,-7,814,22.60,184,1425
1789,63,2012,93,0.00,69,808,7280,3074,2.37,24,-51,3529,12.89,455,8088
1790,65,2012,72,17.00,40,1878,50579,21504,2.35,32,-123,26283,18.18,4779,7291
1791,67,2012,536,154.00,332,141,7150,2940,2.43,204,224,4308,31.75,1368,52457
1792,69,2012,3407,1232.00,1871,8447,302270,124868,2.42,1536,4032,135411,7.79,10543,310717
1793,71,2012,149,22.00,163,783,14183,6181,2.29,-14,13,8245,25.03,2064,14966
1794,73,2012,50,4.00,56,1027,4411,1937,2.28,-6,-9,2425,20.12,488,5438
1795,75,2012,223,13.00,182,3371,18632,7972,2.34,41,-128,9013,11.55,1041,22003
1796,77,2012,1818,338.00,1306,4806,143485,58339,2.46,512,-344,63561,8.22,5222,148291
1797,79,2012,6,9.00,5,0,706,352,2.01,1,-1,1222,71.19,870,706
1798,81,2012,164,10.00,120,102,13033,5201,2.51,44,-311,6219,16.37,1018,13135
1799,83,2012,294,8.00,268,237,25204,10503,2.40,26,-48,12117,13.32,1614,25441
1800,85,2012,402,51.00,451,542,40149,16249,2.47,-49,-154,18425,11.81,2176,40691
1801,87,2012,423,19.00,271,564,27677,10325,2.68,152,-345,11525,10.41,1200,28241
1802,89,2012,270,3.00,258,433,18227,7659,2.38,12,-183,8976,14.67,1317,18660
1803,91,2012,33,19.00,20,0,4510,2057,2.19,13,75,3122,34.11,1065,4510
1804,93,2012,109,73.00,77,92,15960,7105,2.25,32,-76,14137,49.74,7032,16052
1805,95,2012,55,2.00,50,60,4324,1795,2.41,5,6,2093,14.24,298,4384
1806,97,2012,128,33.00,51,72,17150,8184,2.10,77,20,13017,37.13,4833,17222
1807,99,2012,188,8.00,127,315,12065,4866,2.48,61,-148,5951,18.23,1085,12380
1808,101,2012,1878,149.00,1591,4505,156254,63580,2.46,287,137,69986,9.15,6406,160759
1809,103,2012,73,16.00,55,271,6503,2677,2.43,18,-66,3330,19.61,653,6774
1810,105,2012,127,12.00,127,198,11667,4732,2.47,0,-40,6663,28.98,1931,11865
1811,107,2012,216,42.00,92,305,22952,9796,2.34,124,-71,16385,40.21,6589,23257
1812,109,2012,79,25.00,29,18,6298,2733,2.30,50,82,3914,30.17,1181,6316
1813,111,2012,3,1.00,2,0,692,341,2.03,1,-2,759,55.07,418,692
1814,113,2012,72,7.00,31,9,7561,3550,2.13,41,52,6690,46.94,3140,7570
1815,115,2012,21,0.00,38,35,2335,1090,2.14,-17,20,1415,22.97,325,2370
1816,117,2012,309,154.00,57,273,27940,11846,2.36,252,7,30142,60.70,18296,28213
1817,119,2012,154,46.00,144,132,23217,9805,2.37,10,45,12721,22.92,2916,23349
1818,121,2012,40,1.00,50,184,4532,1938,2.34,-10,-63,2442,20.64,504,4716
1819,123,2012,3795,803.00,1456,5847,258077,93336,2.77,2339,3059,98195,4.95,4859,263924
1820,125,2012,157,6.00,112,196,9886,3967,2.49,45,-81,4477,11.39,510,10082
1821,0,2013,64735,26192.00,33624,118977,5149436,2066696,2.49,31111,45167,2258924,8.51,192228,5268413
1822,1,2013,7171,909.00,2798,4028,465449,163451,2.85,4373,5026,165984,1.53,2533,469477
1823,3,2013,223,73.00,146,740,15064,6143,2.45,77,40,6694,8.23,551,15804
1824,5,2013,7821,1318.00,3555,4545,602600,238005,2.53,4266,7322,241472,1.44,3467,607145
1825,7,2013,106,53.00,92,129,12082,5323,2.27,14,88,8930,40.39,3607,12211
1826,9,2013,48,0.00,54,82,3597,1634,2.20,-6,-61,2252,27.44,618,3679
1827,11,2013,38,1.00,62,1715,3993,1704,2.34,-24,-75,2249,24.23,545,5708
1828,13,2013,2963,1411.00,1666,10326,299645,125161,2.39,1297,3334,129798,3.57,4637,309971
1829,14,2013,684,2010.00,323,282,59693,22987,2.60,361,899,23563,2.44,576,59975
1830,15,2013,110,102.00,179,1345,16936,7860,2.15,-69,371,10243,23.26,2383,18281
1831,17,2013,27,4.00,18,42,1847,809,2.28,9,5,985,17.87,176,1889
1832,19,2013,70,6.00,59,76,9019,4215,2.14,11,12,5711,26.20,1496,9095
1833,21,2013,109,13.00,99,36,8193,3108,2.64,10,-27,4335,28.30,1227,8229
1834,23,2013,29,23.00,43,0,3537,1556,2.27,-14,-50,2684,42.03,1128,3537
1835,25,2013,41,0.00,39,2242,3036,1263,2.40,2,-51,1565,19.30,302,5278
1836,27,2013,21,54.00,36,150,4137,1939,2.13,-15,61,4152,53.30,2213,4287
1837,29,2013,320,10.00,317,545,29777,12516,2.38,3,36,14623,14.41,2107,30322
1838,31,2013,9261,5578.00,4216,16123,632039,284663,2.22,5045,8737,294752,3.42,10089,648162
1839,33,2013,17,1.00,18,0,2021,880,2.30,-1,32,1469,40.10,589,2021
1840,35,2013,3429,3435.00,1043,871,305756,109563,2.79,2386,5507,111257,1.52,1694,306627
1841,37,2013,602,90.00,120,70,52264,19271,2.71,482,3,31519,38.86,12248,52334
1842,39,2013,156,44.00,133,20346,636635,248935,2.56,23,238,258857,3.83,9922,23632
1843,41,2013,9086,4901.00,3940,73,23559,8578,2.75,5146,4040,9053,5.25,475,656981
1844,43,2013,335,52.00,529,8384,38057,16553,2.30,-194,-158,19439,14.85,2886,46441
1845,45,2013,822,96.00,281,849,56098,20580,2.73,541,-329,23488,12.38,2908,56947
1846,47,2013,48,8.00,21,49,5522,2519,2.19,27,87,3592,29.87,1073,5571
1847,49,2013,117,44.00,61,222,14049,6236,2.25,56,58,15675,60.22,9439,14271
1848,51,2013,149,47.00,65,1002,14589,6568,2.22,84,-55,11601,43.38,5033,15591
1849,53,2013,10,3.00,5,56,748,344,2.17,5,4,1407,75.55,1063,804
1850,55,2013,50,24.00,88,165,6305,3022,2.09,-38,-55,5165,41.49,2143,6470
1851,57,2013,6,0.00,10,2,1351,630,2.14,-4,19,1297,51.43,667,1353
1852,59,2013,5633,1082.00,4003,7903,543508,224942,2.42,1630,3727,232709,3.34,7767,551411
1853,61,2013,15,2.00,18,14,1390,620,2.24,-3,-18,816,24.02,196,1404
1854,63,2013,83,0.00,76,1056,7213,3044,2.37,7,-74,3529,13.74,485,8269
1855,65,2013,80,20.00,35,2099,51306,21812,2.35,45,-19,26452,17.54,4640,7317
1856,67,2013,495,172.00,315,141,7176,2950,2.43,180,547,4328,31.84,1378,53405
1857,69,2013,3375,1928.00,1990,8623,307661,127042,2.42,1385,4006,137431,7.56,10389,316284
1858,71,2013,147,127.00,185,786,13592,5925,2.29,-38,-553,8368,29.19,2443,14378
1859,73,2013,72,9.00,41,1014,4400,1932,2.28,31,-42,2435,20.66,503,5414
1860,75,2013,252,10.00,199,3318,18491,7911,2.34,53,-194,9020,12.29,1109,21809
1861,77,2013,1854,553.00,1378,5098,143134,58233,2.46,476,-827,64087,9.13,5854,148232
1862,79,2013,4,8.00,4,0,727,362,2.01,0,21,1226,70.47,864,727
1863,81,2013,190,11.00,91,102,12978,5179,2.51,99,-154,6230,16.87,1051,13080
1864,83,2013,293,9.00,252,237,25423,10594,2.40,41,178,12126,12.63,1532,25660
1865,85,2013,455,51.00,383,542,40132,16242,2.47,72,-89,18479,12.11,2237,40674
1866,87,2013,412,26.00,229,564,27655,10317,2.68,183,-205,11559,10.74,1242,28219
1867,89,2013,188,4.00,220,433,18072,7592,2.38,-32,-123,8976,15.42,1384,18505
1868,91,2013,32,23.00,33,0,4544,2071,2.19,-1,35,3144,34.13,1073,4544
1869,93,2013,97,32.00,73,92,16096,7167,2.25,24,112,14169,49.42,7002,16188
1870,95,2013,41,14.00,49,60,4299,1785,2.41,-8,-17,2106,15.24,321,4359
1871,97,2013,124,23.00,43,72,17318,8264,2.10,81,87,13036,36.61,4772,17390
1872,99,2013,167,4.00,118,315,11956,4822,2.48,49,-158,5956,19.04,1134,12271
1873,101,2013,1852,284.00,1622,4470,156615,63728,2.46,230,131,70247,9.28,6519,161085
1874,103,2013,81,6.00,52,277,6445,2652,2.43,29,-87,3340,20.60,688,6722
1875,105,2013,150,13.00,129,198,11498,4663,2.47,21,-190,6675,30.14,2012,11696
1876,107,2013,202,36.00,101,337,23213,9908,2.34,101,160,16413,39.63,6505,23550
1877,109,2013,73,32.00,32,18,6203,2690,2.31,41,-136,3941,31.74,1251,6221
1878,111,2013,1,6.00,5,0,700,344,2.03,-4,12,765,55.03,421,700
1879,113,2013,68,12.00,25,9,7620,3578,2.13,43,16,6702,46.61,3124,7629
1880,115,2013,27,2.00,29,35,2308,1074,2.15,-2,-25,1416,24.15,342,2343
1881,117,2013,248,139.00,53,273,28387,12038,2.36,195,252,30274,60.24,18236,28660
1882,119,2013,165,73.00,125,132,23139,9772,2.37,40,-118,12785,23.57,3013,23271
1883,121,2013,35,1.00,42,184,4581,1959,2.34,-7,56,2443,19.81,484,4765
1884,123,2013,3815,1166.00,1566,5847,264134,95485,2.77,2249,3808,99450,3.99,3965,269981
1885,125,2013,140,4.00,92,233,9924,3983,2.49,48,-10,4480,11.09,497,10157
1886,0,2014,65711,30829.00,34004,119050,5231068,2099139,2.49,31707,49925,2283663,8.08,184524,5350118
1887,1,2014,7044,1495.00,2714,4134,475643,166987,2.85,4330,5864,167154,0.10,167,479777
1888,3,2014,240,50.00,126,865,14980,6109,2.45,114,-198,6727,9.19,618,15845
1889,5,2014,7906,2750.00,3488,4505,613431,242411,2.53,4418,6413,243577,0.48,1166,617936
1890,7,2014,109,70.00,92,129,12129,5343,2.27,17,30,9011,40.71,3668,12258
1891,9,2014,37,0.00,49,82,3542,1612,2.20,-12,-43,2252,28.42,640,3624
1892,11,2014,32,0.00,49,1869,3878,1656,2.34,-17,-98,2249,26.37,593,5747
1893,13,2014,2939,1694.00,1705,10769,302421,126358,2.39,1234,1542,131196,3.69,4838,313190
1894,14,2014,699,896.00,346,282,61272,23596,2.60,353,1226,24620,4.16,1024,61554
1895,15,2014,143,111.00,168,1491,16968,7871,2.16,-25,57,10310,23.66,2439,18459
1896,17,2014,27,1.00,15,42,1805,791,2.28,12,-54,986,19.78,195,1847
1897,19,2014,80,12.00,62,71,9139,4271,2.14,18,102,5718,25.31,1447,9210
1898,21,2014,122,15.00,71,36,8210,3114,2.64,51,-34,4350,28.41,1236,8246
1899,23,2014,28,27.00,42,0,3560,1565,2.27,-14,37,2710,42.25,1145,3560
1900,25,2014,31,3.00,45,2516,3034,1263,2.40,-14,12,1568,19.45,305,5550
1901,27,2014,22,47.00,35,150,4218,1977,2.13,-13,94,4198,52.91,2221,4368
1902,29,2014,292,11.00,361,683,29305,12323,2.38,-69,-403,14687,16.10,2364,29988
1903,31,2014,9327,6117.00,4231,16158,646697,291265,2.22,5096,9562,300694,3.14,9429,662855
1904,33,2014,15,0.00,29,0,1965,856,2.30,-14,-42,1469,41.73,613,1965
1905,35,2014,3536,3883.00,1034,871,313933,112492,2.79,2502,5675,112861,0.33,369,314804
1906,37,2014,659,105.00,122,70,52691,19422,2.71,537,-110,31624,38.58,12202,52761
1907,39,2014,179,78.00,121,20440,644612,252054,2.56,58,403,261627,3.66,9573,24093
1908,41,2014,9181,5173.00,4055,73,24020,8745,2.75,5126,2851,9130,4.22,385,665052
1909,43,2014,380,53.00,542,8226,38163,16598,2.30,-162,268,19507,14.91,2909,46389
1910,45,2014,773,76.00,286,883,56377,20681,2.73,487,-208,23563,12.23,2882,57260
1911,47,2014,40,14.00,30,49,5720,2610,2.19,10,188,3606,27.62,996,5769
1912,49,2014,123,53.00,68,222,14229,6292,2.26,55,125,16421,61.68,10129,14451
1913,51,2014,136,64.00,56,991,14776,6650,2.22,80,107,11664,42.99,5014,15767
1914,53,2014,6,4.00,3,56,718,330,2.18,3,-33,1411,76.61,1081,774
1915,55,2014,41,15.00,98,165,6230,2986,2.09,-57,-18,5179,42.34,2193,6395
1916,57,2014,17,5.00,12,2,1387,647,2.14,5,31,1302,50.31,655,1389
1917,59,2014,5917,1707.00,4106,7914,550696,227944,2.42,1811,5377,234371,2.74,6427,558610
1918,61,2014,19,4.00,20,14,1380,616,2.24,-1,-9,820,24.88,204,1394
1919,63,2014,94,24.00,78,782,7257,3066,2.37,16,28,3553,13.71,487,8039
1920,65,2014,80,0.00,43,1981,51997,22107,2.35,37,8,26731,17.30,4624,7370
1921,67,2014,552,275.00,300,149,7221,2969,2.43,252,439,4328,31.40,1359,53978
1922,69,2014,3490,2447.00,1985,8938,315167,130068,2.42,1505,6001,140013,7.10,9945,324105
1923,71,2014,119,37.00,161,879,13199,5753,2.29,-42,-351,8403,31.54,2650,14078
1924,73,2014,49,8.00,47,1030,4479,1965,2.28,2,77,2442,19.53,477,5509
1925,75,2014,240,21.00,238,3490,18609,7960,2.34,2,116,9035,11.90,1075,22099
1926,77,2014,1760,818.00,1382,4760,143490,58372,2.46,378,-22,64205,9.08,5833,148250
1927,79,2014,5,11.00,4,0,696,347,2.01,1,-32,1228,71.74,881,696
1928,81,2014,176,9.00,94,102,12764,5093,2.51,82,-296,6239,18.37,1146,12866
1929,83,2014,325,6.00,267,237,25569,10655,2.40,58,88,12135,12.20,1480,25806
1930,85,2014,481,72.00,390,542,40227,16281,2.47,91,4,18541,12.19,2260,40769
1931,87,2014,431,22.00,237,564,27563,10282,2.68,194,-286,11596,11.33,1314,28127
1932,89,2014,216,6.00,261,433,17965,7547,2.38,-45,-62,8980,15.96,1433,18398
1933,91,2014,34,29.00,44,0,4582,2089,2.19,-10,48,3162,33.93,1073,4582
1934,93,2014,96,56.00,84,92,16264,7241,2.25,12,156,14224,49.09,6983,16356
1935,95,2014,65,6.00,49,60,4319,1795,2.41,16,4,2111,14.97,316,4379
1936,97,2014,132,45.00,57,72,17551,8385,2.09,75,158,13292,36.92,4907,17623
1937,99,2014,145,3.00,103,315,11708,4723,2.48,42,-290,5956,20.70,1233,12023
1938,101,2014,1921,171.00,1628,4422,157196,63960,2.46,293,288,70406,9.16,6446,161618
1939,103,2014,70,9.00,58,259,6367,2620,2.43,12,-90,3351,21.81,731,6626
1940,105,2014,149,10.00,114,198,11344,4600,2.47,35,-189,6686,31.20,2086,11542
1941,107,2014,208,59.00,105,346,23664,10100,2.34,103,348,16469,38.67,6369,24010
1942,109,2014,55,35.00,46,18,6153,2669,2.31,9,-59,3975,32.86,1306,6171
1943,111,2014,7,0.00,3,0,719,354,2.03,4,15,765,53.73,411,719
1944,113,2014,69,11.00,26,9,7742,3636,2.13,43,79,6714,45.84,3078,7751
1945,115,2014,26,3.00,32,35,2296,1068,2.15,-6,-6,1419,24.74,351,2331
1946,117,2014,271,276.00,68,273,28940,12264,2.36,203,350,30417,59.68,18153,29213
1947,119,2014,195,55.00,174,132,23270,9804,2.37,21,110,12942,24.25,3138,23402
1948,121,2014,47,2.00,51,184,4588,1962,2.34,-4,11,2445,19.75,483,4772
1949,123,2014,3961,1765.00,1616,4761,271084,97976,2.77,2345,4605,100851,2.85,2875,275845
1950,125,2014,142,5.00,78,229,9949,3993,2.49,64,-39,4487,11.01,494,10178
1951,0,2015,66339,28214.00,36213,120981,5327074,2134143,2.50,30126,65880,2312310,7.71,178168,5448055
1952,1,2015,7361,1251.00,2957,4129,485794,168657,2.88,4404,5747,168657,0.00,0,489923
1953,3,2015,215,56.00,128,865,15103,6160,2.45,87,36,6781,9.16,621,15968
1954,5,2015,8130,1458.00,3744,4308,624758,245869,2.54,4386,6941,245869,0.00,0,629066
1955,7,2015,118,75.00,104,129,12288,5414,2.27,14,145,9090,40.44,3676,12417
1956,9,2015,32,0.00,56,82,3512,1598,2.20,-24,-6,2252,29.04,654,3594
1957,11,2015,42,0.00,55,1907,3940,1682,2.34,-13,75,2249,25.21,567,5847
1958,13,2015,2857,1532.00,1787,11125,307445,128444,2.39,1070,3954,132483,3.05,4040,318570
1959,14,2015,671,820.00,358,282,64374,24790,2.60,313,2789,25975,4.56,1185,64656
1960,15,2015,138,147.00,203,1443,17160,7962,2.16,-65,257,10442,23.75,2480,18603
1961,17,2015,29,7.00,19,42,1788,782,2.29,10,-27,992,21.17,210,1830
1962,19,2015,62,11.00,60,97,9295,4344,2.14,2,154,5726,24.14,1382,9392
1963,21,2015,116,13.00,93,36,8038,3048,2.64,23,-195,4365,30.17,1317,8074
1964,23,2015,29,30.00,34,0,3572,1572,2.27,-5,17,2740,42.63,1168,3572
1965,25,2015,42,7.00,34,2580,2989,1243,2.40,8,-53,1575,21.08,332,5569
1966,27,2015,26,43.00,34,150,4307,2019,2.13,-8,97,4240,52.38,2221,4457
1967,29,2015,271,47.00,380,692,29281,12314,2.38,-109,85,14683,16.13,2369,29973
1968,31,2015,9365,5958.00,4316,16517,664141,299122,2.22,5049,12395,306478,2.40,7356,680658
1969,33,2015,19,9.00,13,0,1972,859,2.30,6,1,1476,41.80,617,1972
1970,35,2015,3376,3245.00,1253,871,321327,114977,2.79,2123,5271,114977,0.00,0,322198
1971,37,2015,642,243.00,110,70,53250,19633,2.71,532,27,31870,38.40,12237,53320
1972,39,2015,208,115.00,137,20560,655618,256339,2.56,71,476,264673,3.15,8334,24640
1973,41,2015,9435,3106.00,4149,73,24567,8944,2.75,5286,5720,9242,3.22,298,676178
1974,43,2015,381,55.00,544,8177,38482,16738,2.30,-163,482,19566,14.45,2828,46659
1975,45,2015,767,83.00,340,875,56904,20873,2.73,427,100,23641,11.71,2768,57779
1976,47,2015,39,13.00,34,49,5775,2635,2.19,5,50,3619,27.19,984,5824
1977,49,2015,113,81.00,75,222,14380,6360,2.26,38,113,16518,61.50,10158,14602
1978,51,2015,138,58.00,77,989,15108,6800,2.22,61,271,11722,41.99,4922,16097
1979,53,2015,7,4.00,6,56,711,327,2.17,1,-8,1415,76.89,1088,767
1980,55,2015,55,14.00,103,165,6291,3015,2.09,-48,109,5198,42.00,2183,6456
1981,57,2015,12,0.00,10,2,1351,630,2.14,2,-38,1303,51.65,673,1353
1982,59,2015,5838,2535.00,4398,7932,556687,230469,2.42,1440,4551,237093,2.79,6624,564619
1983,61,2015,14,0.00,22,14,1382,617,2.24,-8,10,819,24.66,202,1396
1984,63,2015,116,2.00,77,1009,7210,3046,2.37,39,-86,3555,14.32,509,8219
1985,65,2015,86,0.00,42,2028,52829,22464,2.35,44,72,27048,16.95,4584,7502
1986,67,2015,579,278.00,346,165,7337,3016,2.43,233,599,4328,30.31,1312,54857
1987,69,2015,3448,2581.00,2246,9373,323457,133417,2.42,1202,7088,142711,6.51,9294,332830
1988,71,2015,125,5.00,178,884,13177,5744,2.29,-53,31,8402,31.64,2658,14061
1989,73,2015,69,2.00,66,1020,4529,1986,2.28,3,47,2444,18.74,458,5549
1990,75,2015,219,20.00,186,3438,18684,7992,2.34,33,42,9048,11.67,1056,22122
1991,77,2015,1826,629.00,1492,5100,143923,58602,2.46,334,99,65137,10.03,6535,149023
1992,79,2015,6,6.00,7,0,729,364,2.00,-1,34,1231,70.43,867,729
1993,81,2015,193,9.00,94,102,12782,5101,2.51,99,-81,6248,18.36,1147,12884
1994,83,2015,329,54.00,246,237,25892,10790,2.40,83,240,12196,11.53,1406,26129
1995,85,2015,454,89.00,457,542,40253,16292,2.47,-3,29,18627,12.54,2335,40795
1996,87,2015,454,32.00,262,564,27666,10320,2.68,192,-89,11644,11.37,1324,28230
1997,89,2015,193,2.00,241,433,17832,7492,2.38,-48,-85,8982,16.59,1490,18265
1998,91,2015,21,33.00,29,0,4647,2118,2.19,-8,73,3184,33.48,1066,4647
1999,93,2015,115,88.00,90,92,16624,7402,2.25,25,335,14311,48.28,6909,16716
2000,95,2015,57,9.00,55,60,4247,1764,2.41,2,-74,2120,16.79,356,4307
2001,97,2015,127,98.00,54,72,17773,8500,2.09,73,149,13512,37.09,5012,17845
2002,99,2015,165,4.00,127,315,11590,4674,2.48,38,-156,5950,21.45,1276,11905
2003,101,2015,1874,108.00,1737,4407,158789,64611,2.46,137,1456,70509,8.36,5898,163196
2004,103,2015,83,9.00,53,259,6270,2580,2.43,30,-127,3356,23.12,776,6529
2005,105,2015,127,11.00,130,198,11215,4548,2.47,-3,-126,6698,32.10,2150,11413
2006,107,2015,214,130.00,100,333,23977,10234,2.34,114,199,16593,38.32,6359,24310
2007,109,2015,78,32.00,60,18,6201,2692,2.30,18,30,4007,32.82,1315,6219
2008,111,2015,6,0.00,6,0,696,342,2.04,0,-23,765,55.29,423,696
2009,113,2015,68,83.00,22,9,7834,3677,2.13,46,46,6794,45.88,3117,7843
2010,115,2015,24,1.00,54,35,2354,1095,2.15,-30,88,1420,22.89,325,2389
2011,117,2015,271,211.00,68,273,29655,12568,2.36,203,512,30589,58.91,18021,29928
2012,119,2015,192,157.00,181,132,23299,9580,2.43,11,18,13004,26.33,3424,23431
2013,121,2015,47,5.00,50,184,4650,1988,2.34,-3,65,2450,18.86,462,4834
2014,123,2015,4083,2500.00,1727,5031,279540,100966,2.77,2356,6100,103219,2.18,2253,284571
2015,125,2015,142,10.00,97,229,9823,3942,2.49,45,-171,4499,12.38,557,10052
2016,0,2016,66559,31871.00,36502,120311,5417869,2168940,2.50,30057,60738,2341918,7.39,172978,5538180
2017,1,2016,7168,2155.00,2925,4184,493489,170132,2.90,4243,3452,170132,0.00,0,497673
2018,3,2016,200,26.00,140,865,15266,6228,2.45,60,103,6853,9.12,625,16131
2019,5,2016,8096,2709.00,3908,4255,632999,248692,2.55,4188,4053,248692,0.00,0,637254
2020,7,2016,117,113.00,89,129,12778,5629,2.27,28,462,9199,38.81,3570,12907
2021,9,2016,38,0.00,62,82,3475,1579,2.20,-24,-13,2252,29.88,673,3557
2022,11,2016,34,2.00,61,1735,3891,1661,2.34,-27,-22,2251,26.21,590,5626
2023,13,2016,2841,1436.00,1803,11053,310936,129842,2.39,1038,2453,133692,2.88,3850,321989
2024,14,2016,734,447.00,375,282,65970,25405,2.60,359,1237,26324,3.49,919,66252
2025,15,2016,134,121.00,180,1501,17596,8170,2.15,-46,482,10664,23.39,2494,19097
2026,17,2016,26,6.00,20,42,1811,792,2.29,6,17,997,20.56,205,1853
2027,19,2016,74,18.00,59,99,9344,4367,2.14,15,34,5740,23.92,1373,9443
2028,21,2016,96,21.00,88,36,8003,3034,2.64,8,-43,4388,30.86,1354,8039
2029,23,2016,30,35.00,46,0,3707,1631,2.27,-16,151,2777,41.27,1146,3707
2030,25,2016,27,5.00,54,2208,3006,1250,2.40,-27,44,1580,20.89,330,5214
2031,27,2016,18,43.00,52,150,4467,2093,2.13,-34,194,4283,51.13,2190,4617
2032,29,2016,281,7.00,355,708,29763,12517,2.38,-74,556,14679,14.73,2162,30471
2033,31,2016,9420,7901.00,4404,16418,676874,304857,2.22,5016,7717,314631,3.11,9774,693292
2034,33,2016,15,0.00,13,0,2035,886,2.30,2,61,1476,39.97,590,2035
2035,35,2016,3494,2890.00,1325,871,327459,117339,2.79,2169,3963,117683,0.29,344,328330
2036,37,2016,664,183.00,119,70,53858,19853,2.71,545,63,32043,38.04,12190,53928
2037,39,2016,201,149.00,124,20681,669526,261764,2.56,77,452,267737,2.23,5973,25169
2038,41,2016,9472,3580.00,4296,73,25096,9136,2.75,5176,8732,9389,2.69,253,690207
2039,43,2016,379,54.00,537,8306,39181,17041,2.30,-158,857,19625,13.17,2584,47487
2040,45,2016,839,138.00,332,884,58100,21310,2.73,507,689,23772,10.36,2462,58984
2041,47,2016,42,16.00,30,49,5877,2682,2.19,12,90,3640,26.32,958,5926
2042,49,2016,127,128.00,63,222,14817,6552,2.26,64,373,16670,60.70,10118,15039
2043,51,2016,158,98.00,77,1019,15375,6920,2.22,81,186,11819,41.45,4899,16394
2044,53,2016,2,6.00,5,56,719,330,2.18,-3,11,1421,76.78,1091,775
2045,55,2016,44,32.00,108,165,6477,3103,2.09,-64,250,5227,40.64,2124,6642
2046,57,2016,12,4.00,12,2,1349,629,2.14,0,-2,1307,51.87,678,1351
2047,59,2016,5904,1914.00,4292,8048,563663,233361,2.42,1612,5364,238917,2.33,5556,571711
2048,61,2016,20,0.00,20,14,1333,596,2.24,0,-49,819,27.23,223,1347
2049,63,2016,94,0.00,79,490,7149,3021,2.37,15,-76,3555,15.02,534,7639
2050,65,2016,64,39.00,44,1977,53720,22851,2.35,20,82,27404,16.61,4553,7595
2051,67,2016,571,336.00,337,156,7439,3057,2.43,234,657,4350,29.72,1293,55697
2052,69,2016,3464,2526.00,2165,9323,329340,135762,2.43,1299,4584,144976,6.36,9214,338663
2053,71,2016,130,3.00,184,883,13199,5752,2.29,-54,76,8405,31.56,2653,14082
2054,73,2016,52,15.00,58,957,4597,2018,2.28,-6,74,2459,17.93,441,5554
2055,75,2016,223,27.00,255,3447,18600,7955,2.34,-32,-52,9070,12.29,1115,22047
2056,77,2016,1709,486.00,1462,5332,145399,59207,2.46,247,1229,65601,9.75,6394,150731
2057,79,2016,8,12.00,5,0,737,368,2.00,3,5,1234,70.18,866,737
2058,81,2016,181,7.00,90,102,12986,5182,2.51,91,113,6255,17.15,1073,13088
2059,83,2016,297,23.00,257,237,26669,11115,2.40,40,737,12225,9.08,1110,26906
2060,85,2016,423,124.00,429,542,40879,16544,2.47,-6,632,18745,11.74,2201,41421
2061,87,2016,428,78.00,281,564,27584,10291,2.68,147,-229,11645,11.63,1354,28148
2062,89,2016,228,4.00,250,433,17857,7500,2.38,-22,47,8986,16.54,1486,18290
2063,91,2016,34,35.00,32,0,4844,2208,2.19,2,195,3215,31.32,1007,4844
2064,93,2016,118,123.00,97,92,17193,7655,2.25,21,548,14432,46.96,6777,17285
2065,95,2016,68,9.00,45,60,4225,1755,2.41,23,-45,2127,17.49,372,4285
2066,97,2016,146,108.00,64,72,17701,8468,2.09,82,-154,13670,38.05,5202,17773
2067,99,2016,185,6.00,149,315,11526,4648,2.48,36,-100,5945,21.82,1297,11841
2068,101,2016,1850,282.00,1706,4406,160703,65397,2.46,144,1770,70701,7.50,5304,165109
2069,103,2016,75,11.00,61,259,6238,2568,2.43,14,-46,3414,24.78,846,6497
2070,105,2016,137,14.00,126,198,11226,4552,2.47,11,0,6712,32.18,2160,11424
2071,107,2016,246,102.00,104,343,24336,10388,2.34,142,217,16689,37.76,6301,24679
2072,109,2016,77,29.00,48,18,6386,2774,2.30,29,156,4036,31.27,1262,6404
2073,111,2016,5,6.00,3,0,698,343,2.03,2,0,771,55.51,428,698
2074,113,2016,68,32.00,27,9,7991,3751,2.13,41,116,6826,45.05,3075,8000
2075,115,2016,29,0.00,35,35,2386,1113,2.14,-6,38,1420,21.62,307,2421
2076,117,2016,295,195.00,64,273,30094,12753,2.36,231,208,30608,58.33,17855,30367
2077,119,2016,191,85.00,171,132,24022,10121,2.37,20,703,13088,22.67,2967,24154
2078,121,2016,57,5.00,66,184,4691,2006,2.34,-9,50,2455,18.29,449,4875
2079,123,2016,4254,2911.00,1734,5031,289366,104485,2.77,2520,7306,105720,1.17,1235,294397
2080,125,2016,145,1.00,100,234,9848,3951,2.49,45,-20,4500,12.20,549,10082
